municipality_id;Gebietsname;eligible_voters;retrieved;invalid;valid;FPOE;FPOE_per
10000;Burgenland;233182;189911;2850;187061;32448;17.34621327
10100;Eisenstadt Stadt;10798;8574;89;8485;1162;13.69475545
10101;Eisenstadt;10798;7192;78;7114;1023;14.38009559
10200;Rust Stadt;1594;1276;21;1255;239;19.0438247
10201;Rust;1594;1055;18;1037;209;20.15429122
10300;Eisenstadt - Umgebung;34307;28264;448;27816;4327;15.55579523
10301;Breitenbrunn am Neusiedler See;1582;1137;27;1110;149;13.42342342
10302;Donnerskirchen;1535;1076;17;1059;200;18.88574127
10303;Großhöflein;1676;1164;25;1139;183;16.0667252
10304;Hornstein;2397;1647;34;1613;267;16.55300682
10305;Klingenbach;870;635;9;626;86;13.73801917
10306;Leithaprodersdorf;965;710;11;699;87;12.44635193
10307;Mörbisch am See;1821;1347;21;1326;262;19.7586727
10308;Müllendorf;1146;868;16;852;108;12.67605634
10309;Neufeld an der Leitha;2642;1868;28;1840;343;18.64130435
10310;Oggau am Neusiedler See;1471;1149;25;1124;164;14.59074733
10311;Oslip;1021;751;14;737;90;12.21166893
10312;Purbach am Neusiedler See;2387;1597;25;1572;283;18.00254453
10313;Sankt Margarethen im Burgenland;2298;1666;26;1640;303;18.47560976
10314;Schützen am Gebirge;1108;849;18;831;112;13.47773767
10315;Siegendorf;2270;1634;29;1605;259;16.13707165
10316;Steinbrunn;2099;1503;16;1487;249;16.74512441
10317;Trausdorf an der Wulka;1658;1150;11;1139;171;15.01316945
10318;Wimpassing an der Leitha;1226;851;12;839;172;20.50059595
10319;Wulkaprodersdorf;1486;1123;24;1099;105;9.554140127
10320;Loretto;411;283;1;282;48;17.0212766
10321;Stotzing;645;470;8;462;76;16.45021645
10322;Zillingtal;761;527;7;520;84;16.15384615
10323;Zagersdorf;832;595;9;586;73;12.45733788
10400;Güssing;21151;17336;227;17109;2828;16.52931206
10401;Bocksdorf;674;488;4;484;104;21.48760331
10402;Burgauberg-Neudauberg;1097;771;13;758;163;21.50395778
10403;Eberau;722;495;7;488;68;13.93442623
10404;Gerersdorf-Sulz;834;601;4;597;83;13.90284757
10405;Güssing;2954;1969;33;1936;314;16.21900826
10406;Güttenbach;725;510;10;500;61;12.2
10407;Heiligenbrunn;651;455;7;448;66;14.73214286
10408;Kukmirn;1651;1122;21;1101;224;20.34514078
10409;Neuberg im Burgenland;833;576;6;570;73;12.80701754
10410;Neustift bei Güssing;412;268;3;265;56;21.13207547
10411;Olbendorf;1200;836;19;817;185;22.64381885
10412;Ollersdorf im Burgenland;805;649;10;639;95;14.86697966
10413;Sankt Michael im Burgenland;811;617;9;608;106;17.43421053
10414;Stegersbach;2091;1419;15;1404;260;18.51851852
10415;Stinatz;940;652;7;645;34;5.271317829
10416;Strem;762;537;9;528;90;17.04545455
10417;Tobaj;1112;808;9;799;166;20.77596996
10418;Hackerberg;287;203;2;201;26;12.93532338
10419;Wörterberg;396;290;3;287;47;16.37630662
10420;Großmürbisch;212;149;1;148;10;6.756756757
10421;Inzenhof;252;197;2;195;31;15.8974359
10422;Kleinmürbisch;205;134;3;131;21;16.03053435
10423;Tschanigraben;54;38;1;37;5;13.51351351
10424;Heugraben;187;152;1;151;32;21.19205298
10425;Rohr im Burgenland;327;241;1;240;50;20.83333333
10426;Bildein;261;214;1;213;36;16.90140845
10427;Rauchwart;371;279;8;271;71;26.19926199
10428;Moschendorf;325;257;4;253;34;13.43873518
10500;Jennersdorf;14311;11323;166;11157;2366;21.2064175
10501;Deutsch Kaltenbrunn;1470;965;19;946;191;20.19027484
10502;Eltendorf;791;533;5;528;126;23.86363636
10503;Heiligenkreuz im Lafnitztal;966;632;8;624;131;20.99358974
10504;Jennersdorf;3465;2257;32;2225;619;27.82022472
10505;Minihof-Liebau;879;633;10;623;141;22.63242376
10506;Mogersdorf;915;650;10;640;132;20.625
10507;Neuhaus am Klausenbach;754;498;5;493;93;18.86409736
10508;Rudersdorf;1835;1214;23;1191;227;19.05961377
10509;Sankt Martin an der Raab;1715;1277;22;1255;246;19.60159363
10510;Weichselbaum;586;447;11;436;85;19.49541284
10511;Königsdorf;611;453;6;447;89;19.91051454
10512;Mühlgraben;324;237;6;231;38;16.45021645
10600;Mattersburg;31587;25758;400;25358;4230;16.68112627
10601;Draßburg;939;624;7;617;74;11.99351702
10602;Forchtenstein;2253;1593;20;1573;285;18.11824539
10603;Hirm;751;583;18;565;83;14.69026549
10604;Loipersbach im Burgenland;988;704;23;681;176;25.84434655
10605;Marz;1615;1208;24;1184;165;13.93581081
10606;Mattersburg;5767;3878;64;3814;661;17.33088621
10607;Neudörfl;3448;2331;35;2296;480;20.90592334
10608;Pöttelsdorf;621;396;5;391;56;14.32225064
10609;Pöttsching;2405;1739;19;1720;261;15.1744186
10610;Rohrbach bei Mattersburg;2130;1559;22;1537;232;15.09433962
10611;Bad Sauerbrunn;1772;1182;16;1166;233;19.98284734
10612;Schattendorf;1937;1494;36;1458;206;14.12894376
10613;Sieggraben;991;739;14;725;152;20.96551724
10614;Sigleß;964;765;5;760;102;13.42105263
10615;Wiesen;2203;1605;30;1575;354;22.47619048
10616;Antau;614;486;11;475;78;16.42105263
10617;Baumgarten;698;517;8;509;61;11.98428291
10618;Zemendorf-Stöttera;1008;712;9;703;94;13.371266
10619;Krensdorf;483;350;8;342;61;17.83625731
10700;Neusiedl am See;45429;36582;580;36002;6451;17.91844898
10701;Andau;1919;1452;18;1434;299;20.85076709
10702;Apetlon;1525;1142;15;1127;170;15.08429459
10703;Bruckneudorf;2368;1532;21;1511;371;24.55327598
10704;Deutsch Jahrndorf;443;346;7;339;74;21.82890855
10705;Frauenkirchen;2350;1566;34;1532;272;17.75456919
10706;Gattendorf;951;716;12;704;147;20.88068182
10707;Gols;3133;2228;40;2188;468;21.38939671
10708;Halbturn;1594;1210;19;1191;223;18.72376154
10709;Illmitz;2053;1617;21;1596;242;15.16290727
10710;Jois;1268;895;15;880;172;19.54545455
10711;Kittsee;1508;1002;16;986;153;15.51724138
10712;Mönchhof;1828;1289;27;1262;234;18.54199683
10713;Neusiedl am See;6233;3952;57;3895;623;15.99486521
10714;Nickelsdorf;1254;887;15;872;191;21.90366972
10715;Pama;858;656;9;647;55;8.500772798
10716;Pamhagen;1365;914;11;903;120;13.28903654
10717;Parndorf;3286;2060;39;2021;466;23.05789213
10718;Podersdorf am See;1755;1281;26;1255;190;15.13944223
10719;Sankt Andrä am Zicksee;1127;878;9;869;148;17.0310702
10720;Tadten;1009;753;8;745;84;11.27516779
10721;Wallern im Burgenland;1421;1099;25;1074;208;19.36685289
10722;Weiden am See;1933;1382;21;1361;273;20.05878031
10723;Winden am See;1077;719;18;701;117;16.69044223
10724;Zurndorf;1677;1278;32;1246;333;26.72552167
10725;Neudorf;563;399;5;394;53;13.45177665
10726;Potzneusiedl;434;324;4;320;72;22.5
10727;Edelstal;497;356;3;353;51;14.44759207
10800;Oberpullendorf;30701;25504;406;25098;3628;14.45533509
10801;Deutschkreutz;2522;1780;24;1756;271;15.43280182
10802;Draßmarkt;1136;847;13;834;81;9.712230216
10803;Frankenau-Unterpullendorf;922;653;7;646;69;10.68111455
10804;Großwarasdorf;1164;807;9;798;90;11.27819549
10805;Horitschon;1464;1087;16;1071;182;16.99346405
10806;Kaisersdorf;480;361;5;356;47;13.20224719
10807;Kobersdorf;1550;1172;16;1156;216;18.68512111
10808;Lackenbach;929;632;11;621;108;17.39130435
10809;Lockenhaus;1649;1133;21;1112;195;17.53597122
10810;Lutzmannsburg;704;524;4;520;93;17.88461538
10811;Mannersdorf an der Rabnitz;1477;1108;27;1081;209;19.33395005
10812;Markt Sankt Martin;990;776;17;759;113;14.88801054
10813;Neckenmarkt;1412;1069;10;1059;144;13.59773371
10814;Neutal;894;715;14;701;92;13.12410842
10815;Nikitsch;1154;812;11;801;74;9.238451935
10816;Oberpullendorf;2501;1463;29;1434;224;15.62064156
10817;Pilgersdorf;1385;1026;22;1004;135;13.44621514
10818;Piringsdorf;712;542;11;531;54;10.16949153
10819;Raiding;742;485;11;474;44;9.282700422
10820;Ritzing;747;536;12;524;92;17.55725191
10821;Steinberg-Dörfl;1041;801;18;783;117;14.94252874
10822;Stoob;1142;828;16;812;109;13.42364532
10823;Weppersdorf;1507;1124;26;1098;211;19.21675774
10824;Lackendorf;490;336;5;331;46;13.89728097
10825;Unterfrauenhaid;526;388;7;381;51;13.38582677
10826;Unterrabnitz-Schwendgraben;527;424;7;417;46;11.03117506
10827;Weingraben;277;226;0;226;17;7.522123894
10828;Oberloisdorf;657;512;16;496;78;15.72580645
10900;Oberwart;43304;34575;506;34069;7101;20.8429951
10901;Bad Tatzmannsdorf;1270;831;15;816;178;21.81372549
10902;Bernstein;1780;1243;20;1223;207;16.9255928
10903;Deutsch Schützen-Eisenberg;949;742;15;727;144;19.80742779
10904;Grafenschachen;1051;809;23;786;188;23.91857506
10905;Großpetersdorf;2881;1897;27;1870;311;16.63101604
10906;Hannersdorf;627;447;5;442;59;13.34841629
10907;Kemeten;1236;876;9;867;258;29.75778547
10908;Kohfidisch;1193;894;21;873;173;19.81672394
10909;Litzelsdorf;951;691;11;680;202;29.70588235
10910;Loipersdorf-Kitzladen;1051;839;16;823;210;25.5164034
10911;Mariasdorf;990;708;10;698;182;26.07449857
10912;Markt Allhau;1505;1117;17;1100;243;22.09090909
10913;Markt Neuhodis;554;412;4;408;54;13.23529412
10914;Mischendorf;1342;1022;18;1004;136;13.54581673
10915;Oberdorf im Burgenland;849;644;14;630;127;20.15873016
10916;Oberschützen;1891;1295;16;1279;306;23.92494136
10917;Oberwart;5653;3515;40;3475;708;20.37410072
10918;Pinkafeld;4503;2873;49;2824;787;27.86827195
10919;Rechnitz;2409;1607;26;1581;360;22.77039848
10920;Riedlingsdorf;1334;912;23;889;288;32.39595051
10921;Rotenturm an der Pinka;1153;887;12;875;121;13.82857143
10922;Schachendorf;547;405;6;399;61;15.28822055
10923;Stadtschlaining;1629;1117;16;1101;221;20.07266122
10924;Unterkohlstätten;830;661;6;655;83;12.67175573
10925;Unterwart;673;478;6;472;88;18.6440678
10926;Weiden bei Rechnitz;685;540;5;535;109;20.37383178
10927;Wiesfleck;958;702;7;695;186;26.76258993
10928;Wolfau;1116;798;10;788;188;23.85786802
10929;Neustift an der Lafnitz;653;493;8;485;103;21.2371134
10930;Jabing;590;457;7;450;79;17.55555556
10931;Badersdorf;243;193;4;189;34;17.98941799
10932;Schandorf;208;152;2;150;20;13.33333333
20000;Kärnten;437785;317146;5334;311812;61674;19.77922594
20100;Klagenfurt Stadt;73873;51678;701;50977;8055;15.8012437
20101;Klagenfurt am Wörthersee;73873;43331;649;42682;7166;16.78927885
20200;Villach Stadt;44596;31257;446;30811;5494;17.83129402
20201;Villach;44596;27169;423;26746;5010;18.73177298
20300;Hermagor;14669;11521;225;11296;1923;17.02372521
20302;Dellach;1027;663;19;644;111;17.23602484
20305;Hermagor-Pressegger See;5457;3452;60;3392;612;18.04245283
20306;Kirchbach;2109;1401;23;1378;283;20.53701016
20307;Kötschach-Mauthen;2718;1666;57;1609;234;14.54319453
20316;St. Stefan im Gailtal;1304;868;25;843;133;15.77698695
20320;Gitschtal;974;660;10;650;170;26.15384615
20321;Lesachtal;1080;737;14;723;62;8.57538036
20400;Klagenfurt-Land;47226;35112;577;34535;5979;17.312871
20402;Ebenthal in Kärnten;6359;4020;57;3963;858;21.65026495
20403;Feistritz im Rosental;1949;1143;24;1119;182;16.26452189
20405;Ferlach;5473;3363;79;3284;647;19.70158343
20409;Grafenstein;2327;1450;43;1407;271;19.26083866
20412;Keutschach am See;1967;1123;14;1109;150;13.52569883
20414;Köttmannsdorf;2380;1556;29;1527;280;18.33660773
20415;Krumpendorf am Wörthersee;2625;1542;15;1527;216;14.1453831
20416;Ludmannsdorf;1444;915;9;906;119;13.13465784
20417;Maria Rain;1986;1254;23;1231;246;19.98375305
20418;Maria Saal;3130;1959;34;1925;315;16.36363636
20419;Maria Wörth;1283;687;4;683;95;13.90922401
20421;Moosburg;3612;2026;31;1995;432;21.65413534
20424;Pörtschach am Wörther See;2236;1269;16;1253;186;14.8443735
20425;Poggersdorf;2558;1793;37;1756;346;19.70387244
20428;St. Margareten im Rosental;879;538;14;524;76;14.50381679
20432;Schiefling am Wörthersee;1962;1258;21;1237;235;18.99757478
20435;Techelsberg am Wörther See;1780;1000;27;973;193;19.83556012
20441;Zell;502;324;9;315;12;3.80952381
20442;Magdalensberg;2774;1746;34;1712;307;17.93224299
20500;Sankt Veit an der Glan;44371;31680;556;31124;7333;23.56059632
20501;Althofen;3795;2212;36;2176;465;21.36948529
20502;Brückl;2250;1407;38;1369;293;21.40248356
20503;Deutsch-Griffen;750;411;6;405;198;48.88888889
20504;Eberstein;1020;607;14;593;168;28.33052277
20505;Friesach;4235;2389;30;2359;612;25.94319627
20506;Glödnitz;667;396;7;389;116;29.82005141
20508;Gurk;1015;730;17;713;221;30.99579243
20509;Guttaring;1201;748;19;729;143;19.61591221
20511;Hüttenberg;1182;711;7;704;241;34.23295455
20512;Kappel am Krappfeld;1582;1062;21;1041;229;21.99807877
20513;Klein St. Paul;1458;938;20;918;250;27.23311547
20515;Liebenfels;2661;1671;29;1642;339;20.6455542
20518;Metnitz;1663;1136;28;1108;301;27.16606498
20519;Micheldorf;846;444;15;429;100;23.31002331
20520;Mölbling;1063;669;13;656;227;34.60365854
20523;St. Georgen am Längsee;2926;1834;27;1807;419;23.18760376
20527;St. Veit an der Glan;9764;5364;100;5264;1020;19.3768997
20530;Straßburg;1678;1089;29;1060;329;31.03773585
20531;Weitensfeld im Gurktal;1724;1092;15;1077;333;30.91922006
20534;Frauenstein;2891;1906;28;1878;431;22.94994675
20600;Spittal an der Drau;61469;44690;737;43953;10148;23.08829886
20601;Bad Kleinkirchheim;1295;636;4;632;181;28.63924051
20602;Baldramsdorf;1553;915;20;895;258;28.82681564
20603;Berg im Drautal;1050;672;14;658;71;10.79027356
20604;Dellach im Drautal;1321;780;17;763;117;15.33420708
20605;Großkirchheim;1074;713;4;709;212;29.90126939
20607;Flattach;963;577;8;569;151;26.53778559
20608;Gmünd in Kärnten;2139;1353;37;1316;326;24.77203647
20609;Greifenburg;1377;859;16;843;217;25.74139976
20610;Heiligenblut am Großglockner;826;494;15;479;99;20.66805846
20611;Irschen;1620;1089;21;1068;212;19.85018727
20613;Kleblach-Lind;973;675;17;658;122;18.54103343
20616;Lendorf;1430;897;13;884;224;25.33936652
20618;Mallnitz;627;415;2;413;51;12.34866828
20619;Malta;1653;938;22;916;273;29.80349345
20620;Millstatt am See;2757;1593;19;1574;299;18.99618806
20622;Mörtschach;679;416;5;411;117;28.46715328
20624;Mühldorf;823;508;7;501;210;41.91616766
20625;Oberdrauburg;969;616;15;601;127;21.13144759
20627;Obervellach;1772;1036;7;1029;249;24.19825073
20630;Radenthein;4811;2834;59;2775;713;25.69369369
20631;Rangersdorf;1347;768;11;757;251;33.15719947
20632;Rennweg am Katschberg;1471;979;22;957;207;21.63009404
20633;Sachsenburg;1030;668;8;660;181;27.42424242
20634;Seeboden am Millstätter See;5173;3130;60;3070;710;23.12703583
20635;Spittal an der Drau;11790;6658;126;6532;1448;22.16778934
20636;Stall;1302;793;12;781;294;37.64404609
20637;Steinfeld;1646;1027;16;1011;236;23.34322453
20638;Trebesing;947;590;16;574;152;26.48083624
20639;Weißensee;617;384;4;380;72;18.94736842
20640;Winklern;1004;537;7;530;133;25.09433962
20642;Krems in Kärnten;1438;872;14;858;228;26.57342657
20643;Lurnfeld;2214;1291;23;1268;326;25.70977918
20644;Reißeck;1778;1137;20;1117;279;24.97761862
20700;Villach-Land;51393;38059;706;37353;7634;20.43744813
20701;Afritz am See;1196;725;17;708;206;29.0960452
20702;Arnoldstein;5215;3242;65;3177;651;20.49102927
20703;Arriach;1133;657;17;640;224;35
20705;Bad Bleiberg;1798;1010;19;991;196;19.77800202
20707;Feistritz an der Gail;503;336;6;330;56;16.96969697
20708;Feld am See;889;552;14;538;154;28.62453532
20710;Ferndorf;1762;1160;26;1134;312;27.51322751
20711;Finkenstein am Faaker See;7036;4459;85;4374;795;18.17558299
20712;Fresach;1024;713;20;693;216;31.16883117
20713;Hohenthurn;646;422;6;416;55;13.22115385
20719;Nötsch im Gailtal;1839;1231;18;1213;247;20.36273702
20720;Paternion;4773;3086;74;3012;614;20.38512616
20721;Rosegg;1485;913;22;891;199;22.33445567
20722;St. Jakob im Rosental;3440;2119;31;2088;318;15.22988506
20723;Stockenboi;1309;876;33;843;257;30.48635824
20724;Treffen am Ossiacher See;3606;2071;41;2030;464;22.85714286
20725;Velden am Wörther See;6947;4130;69;4061;759;18.68997784
20726;Weißenstein;2438;1614;25;1589;358;22.52989301
20727;Wernberg;4354;2780;50;2730;623;22.82051282
20800;Völkermarkt;33234;24335;512;23823;4114;17.26902573
20801;Bleiburg;3019;1837;38;1799;269;14.95275153
20802;Diex;631;447;14;433;119;27.48267898
20803;Eberndorf;4710;2894;55;2839;541;19.05600564
20804;Eisenkappel-Vellach;1796;1157;30;1127;129;11.44631766
20805;Feistritz ob Bleiburg;1704;1137;34;1103;190;17.22574796
20806;Gallizien;1434;946;25;921;152;16.50380022
20807;Globasnitz;1289;821;24;797;133;16.68757842
20808;Griffen;2776;1797;40;1757;370;21.05862265
20810;Neuhaus;868;490;10;480;110;22.91666667
20812;Ruden;1241;768;31;737;152;20.62415197
20813;St. Kanzian am Klopeiner See;3453;2159;41;2118;374;17.65816808
20815;Sittersdorf;1628;982;25;957;147;15.36050157
20817;Völkermarkt;8685;5323;115;5208;997;19.14362519
20900;Wolfsberg;43039;30595;544;30051;6785;22.57828358
20901;Bad St. Leonhard im Lavanttal;3582;2284;29;2255;470;20.84257206
20905;Frantschach-St. Gertraud;2030;1290;23;1267;284;22.41515391
20909;Lavamünd;2392;1486;28;1458;368;25.24005487
20911;Preitenegg;782;537;5;532;140;26.31578947
20912;Reichenfels;1494;1002;23;979;207;21.14402451
20913;St. Andrä;8237;4972;89;4883;1358;27.81077207
20914;St. Georgen im Lavanttal;1652;1052;29;1023;329;32.16031281
20918;St. Paul im Lavanttal;2727;1671;23;1648;444;26.94174757
20923;Wolfsberg;20143;12317;253;12064;2525;20.93003979
21000;Feldkirchen;23915;16874;315;16559;4056;24.49423274
21001;Albeck;791;488;13;475;178;37.47368421
21002;Feldkirchen in Kärnten;11446;6609;126;6483;1602;24.71078205
21003;Glanegg;1539;883;15;868;168;19.35483871
21004;Gnesau;824;533;11;522;145;27.77777778
21005;Himmelberg;1845;1151;34;1117;323;28.91674127
21006;Ossiach;576;356;8;348;90;25.86206897
21007;Reichenau;1431;866;25;841;223;26.51605232
21008;St. Urban;1191;691;11;680;246;36.17647059
21009;Steindorf am Ossiacher See;2952;1734;28;1706;407;23.85697538
21010;Steuerberg;1320;771;16;755;177;23.44370861
30000;Niederösterreich;1292902;1042486;15210;1027276;168565;16.40893002
30100;Krems an der Donau Stadt;18070;13703;172;13531;2014;14.88433966
30101;Krems an der Donau;18070;11430;159;11271;1779;15.78387011
30200;Sankt Pölten Stadt;39559;30076;426;29650;4451;15.01180438
30201;St. Pölten;39559;25632;387;25245;3963;15.69815805
30300;Waidhofen an der Ybbs Stadt;8910;7353;108;7245;880;12.1463078
30301;Waidhofen an der Ybbs;8910;6067;99;5968;776;13.00268097
30400;Wiener Neustadt Stadt;31417;22376;254;22122;4523;20.44571015
30401;Wiener Neustadt;31417;19229;228;19001;4058;21.3567707
30500;Amstetten;90724;74542;1253;73289;11935;16.28484493
30501;Allhartsberg;1715;1286;30;1256;176;14.01273885
30502;Amstetten;17357;11537;189;11348;2207;19.44836094
30503;Ardagger;2819;2164;55;2109;377;17.87577051
30504;Aschbach-Markt;2937;1962;26;1936;347;17.92355372
30506;Behamberg;2686;2022;39;1983;366;18.45688351
30507;Biberbach;1838;1392;17;1375;227;16.50909091
30508;Ennsdorf;2288;1581;25;1556;270;17.35218509
30509;Ernsthofen;1862;1282;22;1260;173;13.73015873
30510;Ertl;1020;725;16;709;153;21.5796897
30511;Euratsfeld;2115;1719;29;1690;252;14.9112426
30512;Ferschnitz;1467;1088;16;1072;180;16.79104478
30514;Haag;4513;2970;58;2912;405;13.90796703
30515;Haidershofen;2964;2183;41;2142;373;17.41363212
30516;Hollenstein an der Ybbs;1354;972;18;954;91;9.538784067
30517;Kematen an der Ybbs;1931;1408;39;1369;251;18.33455077
30520;Neuhofen an der Ybbs;2301;1690;31;1659;302;18.20373719
30521;Neustadtl an der Donau;1701;1317;24;1293;226;17.47873163
30522;Oed-Oehling;1510;986;18;968;176;18.18181818
30524;Opponitz;695;538;12;526;79;15.01901141
30526;St. Georgen am Reith;442;350;2;348;58;16.66666667
30527;St. Georgen am Ybbsfelde;2249;1548;17;1531;286;18.68060091
30529;St. Pantaleon-Erla;2115;1477;33;1444;241;16.68975069
30530;St. Peter in der Au;4113;2891;62;2829;483;17.07317073
30531;St. Valentin;7434;5138;91;5047;804;15.9302556
30532;Seitenstetten;2680;1919;42;1877;305;16.24933404
30533;Sonntagberg;3090;2139;42;2097;321;15.30758226
30534;Strengberg;1621;1156;21;1135;173;15.24229075
30536;Viehdorf;1074;812;10;802;133;16.58354115
30538;Wallsee-Sindelburg;1721;1078;18;1060;177;16.69811321
30539;Weistrach;1848;1315;28;1287;208;16.16161616
30541;Winklarn;1371;1010;20;990;179;18.08080808
30542;Wolfsbach;1586;1171;23;1148;177;15.41811847
30543;Ybbsitz;2818;2155;23;2132;306;14.35272045
30544;Zeillern;1489;1075;16;1059;172;16.24173749
30600;Baden;107228;83964;1088;82876;14303;17.25831363
30601;Alland;1995;1273;13;1260;230;18.25396825
30602;Altenmarkt an der Triesting;1529;1083;17;1066;185;17.35459662
30603;Bad Vöslau;8743;5836;80;5756;854;14.83669215
30604;Baden;18857;12159;128;12031;1582;13.14936414
30605;Berndorf;6427;4120;82;4038;806;19.96037642
30607;Ebreichsdorf;8168;5355;62;5293;1177;22.23691668
30608;Enzesfeld-Lindabrunn;3306;2335;49;2286;447;19.55380577
30609;Furth an der Triesting;675;516;8;508;74;14.56692913
30612;Günselsdorf;1295;904;17;887;187;21.08229989
30613;Heiligenkreuz;1121;811;10;801;134;16.72908864
30614;Hernstein;1270;1006;13;993;160;16.11278953
30615;Hirtenberg;1639;1099;17;1082;263;24.30683919
30616;Klausen-Leopoldsdorf;1358;847;12;835;189;22.63473054
30618;Kottingbrunn;5610;3808;46;3762;684;18.18181818
30620;Leobersdorf;3573;2336;31;2305;445;19.30585683
30621;Mitterndorf an der Fischa;1960;1273;23;1250;344;27.52
30623;Oberwaltersdorf;3445;2224;24;2200;369;16.77272727
30625;Pfaffstätten;2642;1931;14;1917;239;12.46739697
30626;Pottendorf;5290;3493;52;3441;750;21.79598954
30627;Pottenstein;2163;1431;19;1412;250;17.70538244
30629;Reisenberg;1319;947;19;928;223;24.03017241
30631;Schönau an der Triesting;1607;1071;19;1052;163;15.49429658
30633;Seibersdorf;1203;869;16;853;172;20.16412661
30635;Sooß;778;569;9;560;78;13.92857143
30636;Tattendorf;1101;850;8;842;141;16.74584323
30637;Teesdorf;1403;1049;16;1033;164;15.87608906
30639;Traiskirchen;13405;9462;140;9322;1767;18.95515984
30641;Trumau;2642;1894;29;1865;349;18.71313673
30645;Weissenbach an der Triesting;1298;898;17;881;172;19.52326901
30646;Blumau-Neurißhof;1406;871;12;859;229;26.6589057
30700;Bruck an der Leitha;72905;56460;747;55713;10395;18.65812288
30701;Au am Leithaberge;767;582;12;570;130;22.80701754
30702;Bad Deutsch-Altenburg;1187;803;9;794;198;24.93702771
30703;Berg;492;387;4;383;49;12.79373368
30704;Bruck an der Leitha;5803;3849;41;3808;665;17.46323529
30706;Enzersdorf an der Fischa;2578;1812;25;1787;391;21.88024622
30708;Göttlesbrunn-Arbesthal;1132;863;11;852;144;16.90140845
30709;Götzendorf an der Leitha;1528;1146;24;1122;184;16.39928699
30710;Hainburg a.d. Donau;3735;2336;31;2305;485;21.04121475
30711;Haslau-Maria Ellend;1475;1029;9;1020;176;17.25490196
30712;Höflein;988;750;13;737;148;20.08141113
30713;Hof am Leithaberge;1188;931;16;915;207;22.62295082
30715;Hundsheim;474;374;7;367;74;20.16348774
30716;Mannersdorf am Leithagebirge;2932;2091;36;2055;342;16.64233577
30718;Petronell-Carnuntum;955;687;5;682;110;16.12903226
30719;Prellenkirchen;1185;851;12;839;142;16.92491061
30721;Rohrau;1214;879;11;868;167;19.23963134
30722;Scharndorf;927;703;15;688;92;13.37209302
30724;Sommerein;1613;1175;14;1161;250;21.53316107
30726;Trautmannsdorf an der Leitha;2353;1658;27;1631;271;16.61557327
30728;Wolfsthal;568;424;5;419;79;18.85441527
30729;Ebergassing;2722;1710;20;1690;357;21.12426036
30730;Fischamend;4074;2411;38;2373;516;21.74462705
30731;Gramatneusiedl;2315;1477;21;1456;267;18.33791209
30732;Himberg;5577;3606;56;3550;709;19.97183099
30733;Klein-Neusiedl;632;416;4;412;76;18.44660194
30734;Lanzendorf;1388;897;9;888;138;15.54054054
30735;Leopoldsdorf;3943;2654;27;2627;451;17.1678721
30736;Maria-Lanzendorf;1625;1037;16;1021;231;22.62487757
30737;Moosbrunn;1326;927;12;915;147;16.06557377
30738;Rauchenwarth;572;410;14;396;38;9.595959596
30739;Schwadorf;1560;970;17;953;185;19.41238195
30740;Schwechat;12751;7685;104;7581;1596;21.05263158
30741;Zwölfaxing;1326;856;9;847;202;23.84887839
30800;Gänserndorf;78441;61164;761;60403;11679;19.33513236
30801;Aderklaa;150;109;1;108;17;15.74074074
30802;Andlersdorf;105;74;0;74;6;8.108108108
30803;Angern an der March;2544;1753;19;1734;358;20.64590542
30804;Auersthal;1471;1112;13;1099;150;13.64877161
30805;Bad Pirawarth;1312;891;16;875;134;15.31428571
30808;Deutsch-Wagram;6618;4368;59;4309;914;21.21141796
30810;Drösing;927;628;5;623;122;19.58266453
30811;Dürnkrut;1800;1232;15;1217;301;24.73294988
30812;Ebenthal;686;524;12;512;119;23.2421875
30813;Eckartsau;954;684;7;677;138;20.38404727
30814;Engelhartstetten;1577;1097;12;1085;234;21.56682028
30817;Gänserndorf;8239;5295;66;5229;1018;19.46834959
30819;Glinzendorf;214;147;1;146;37;25.34246575
30821;Groß-Enzersdorf;8484;5518;65;5453;976;17.89840455
30822;Großhofen;65;56;0;56;5;8.928571429
30824;Groß-Schweinbarth;1016;781;20;761;97;12.74638633
30825;Haringsee;915;652;9;643;100;15.55209953
30826;Hauskirchen;1020;699;12;687;125;18.19505095
30827;Hohenau an der March;2130;1342;17;1325;287;21.66037736
30828;Hohenruppersdorf;756;584;9;575;79;13.73913043
30829;Jedenspeigen;916;680;9;671;84;12.51862891
30830;Lassee;2106;1522;20;1502;382;25.43275632
30831;Leopoldsdorf im Marchfelde;2089;1457;20;1437;297;20.66805846
30834;Mannsdorf an der Donau;271;198;2;196;41;20.91836735
30835;Marchegg;2092;1407;13;1394;310;22.23816356
30836;Markgrafneusiedl;719;512;8;504;118;23.41269841
30838;Matzen-Raggendorf;2104;1512;22;1490;249;16.7114094
30841;Neusiedl an der Zaya;1002;684;7;677;154;22.74741507
30842;Obersiebenbrunn;1324;871;5;866;211;24.36489607
30844;Orth an der Donau;1634;997;18;979;211;21.5526047
30845;Palterndorf-Dobermannsdorf;1045;731;10;721;179;24.82662968
30846;Parbasdorf;132;111;0;111;17;15.31531532
30848;Prottes;1093;738;12;726;139;19.14600551
30849;Raasdorf;429;319;5;314;24;7.643312102
30850;Ringelsdorf-Niederabsdorf;1030;710;13;697;98;14.06025825
30852;Schönkirchen-Reyersdorf;1515;1082;8;1074;204;18.99441341
30854;Spannberg;788;608;11;597;134;22.44556114
30856;Strasshof an der Nordbahn;7505;4763;46;4717;1098;23.27750689
30857;Sulz im Weinviertel;997;722;12;710;123;17.32394366
30858;Untersiebenbrunn;1334;946;11;935;247;26.4171123
30859;Velm-Götzendorf;632;494;8;486;103;21.19341564
30860;Weikendorf;1551;1076;13;1063;220;20.69614299
30863;Zistersdorf;4409;2982;59;2923;510;17.44782757
30865;Weiden an der March;741;534;8;526;77;14.63878327
30900;Gmünd;30485;24207;487;23720;3789;15.97386172
30902;Amaliendorf-Aalfang;919;555;17;538;134;24.9070632
30903;Brand-Nagelberg;1306;870;22;848;124;14.62264151
30904;Eggern;576;409;8;401;88;21.94513716
30906;Eisgarn;553;374;6;368;54;14.67391304
30908;Gmünd;4144;2626;42;2584;416;16.09907121
30909;Großdietmanns;1860;1322;33;1289;206;15.98138092
30910;Bad Großpertholz;1101;697;22;675;100;14.81481481
30912;Großschönau;991;754;12;742;125;16.84636119
30913;Moorbad Harbach;599;427;10;417;77;18.46522782
30915;Haugschlag;387;269;7;262;53;20.22900763
30916;Heidenreichstein;3360;2033;47;1986;317;15.96173212
30917;Hirschbach;496;357;3;354;52;14.68926554
30920;Hoheneich;1200;770;13;757;121;15.98414795
30921;Kirchberg am Walde;1089;771;17;754;126;16.71087533
30925;Litschau;1927;1155;15;1140;180;15.78947368
30929;Reingers;523;374;4;370;61;16.48648649
30932;St. Martin;915;633;18;615;94;15.28455285
30935;Schrems;4457;2841;64;2777;448;16.1325171
30939;Unserfrau-Altweitra;831;606;21;585;86;14.7008547
30940;Waldenstein;999;697;19;678;96;14.15929204
30942;Weitra;2252;1415;21;1394;228;16.35581062
31000;Hollabrunn;41431;33412;576;32836;5076;15.45864295
31001;Alberndorf im Pulkautal;626;426;13;413;76;18.40193705
31008;Göllersdorf;2342;1673;29;1644;262;15.93673966
31009;Grabern;1268;917;18;899;127;14.12680756
31014;Guntersdorf;933;681;12;669;129;19.28251121
31015;Hadres;1434;1094;20;1074;200;18.62197393
31016;Hardegg;1107;841;17;824;112;13.59223301
31018;Haugsdorf;1303;906;27;879;173;19.6814562
31019;Heldenberg;1064;731;13;718;121;16.85236769
31021;Hohenwarth-Mühlbach a.M.;1085;781;12;769;102;13.26397919
31022;Hollabrunn;9183;6029;91;5938;980;16.50387336
31025;Mailberg;479;345;12;333;51;15.31531532
31026;Maissau;1637;1054;11;1043;153;14.66922339
31028;Nappersdorf-Kammersdorf;1014;694;7;687;127;18.48617176
31033;Pernersdorf;853;619;16;603;112;18.57379768
31035;Pulkau;1264;851;20;831;90;10.83032491
31036;Ravelsbach;1328;895;19;876;145;16.55251142
31037;Retz;3531;2158;33;2125;259;12.18823529
31038;Retzbach;838;587;14;573;110;19.19720768
31041;Schrattenthal;729;534;12;522;43;8.237547893
31042;Seefeld-Kadolz;796;542;5;537;100;18.62197393
31043;Sitzendorf an der Schmida;1800;1315;16;1299;165;12.70207852
31051;Wullersdorf;1975;1387;27;1360;251;18.45588235
31052;Zellerndorf;2064;1499;26;1473;241;16.36116768
31053;Ziersdorf;2778;1940;41;1899;298;15.69246972
31100;Horn;25601;20964;336;20628;3099;15.02326934
31101;Altenburg;659;469;6;463;98;21.1663067
31102;Brunn an der Wild;692;512;9;503;76;15.10934394
31103;Burgschleinitz-Kühnring;1135;783;15;768;103;13.41145833
31104;Drosendorf-Zissersdorf;999;709;9;700;129;18.42857143
31105;Eggenburg;2844;1816;40;1776;243;13.68243243
31106;Gars am Kamp;2954;1996;30;1966;352;17.90437436
31107;Geras;1087;775;11;764;123;16.09947644
31109;Horn;5160;3112;49;3063;507;16.55239961
31110;Irnfritz-Messern;1187;865;14;851;157;18.44888367
31111;Japons;599;452;6;446;56;12.55605381
31113;Langau;579;415;6;409;60;14.66992665
31114;Meiseldorf;758;502;4;498;87;17.46987952
31117;Pernegg;602;455;9;446;82;18.38565022
31119;Röhrenbach;443;328;8;320;58;18.125
31120;Röschitz;892;651;12;639;71;11.11111111
31121;Rosenburg-Mold;672;467;8;459;87;18.95424837
31123;St. Bernhard-Frauenhofen;1054;784;12;772;89;11.52849741
31124;Sigmundsherberg;1369;933;20;913;143;15.6626506
31129;Weitersfeld;1311;991;16;975;106;10.87179487
31130;Straning-Grafenberg;605;433;8;425;45;10.58823529
31200;Korneuburg;69958;56797;669;56128;8193;14.59699259
31201;Bisamberg;3666;2482;29;2453;228;9.294741133
31202;Enzersfeld im Weinviertel;1389;991;15;976;125;12.80737705
31203;Ernstbrunn;2594;1752;26;1726;258;14.94785632
31204;Großmugl;1323;963;12;951;150;15.77287066
31205;Großrußbach;1757;1296;25;1271;170;13.37529504
31206;Hagenbrunn;1661;1149;8;1141;191;16.73970202
31207;Harmannsdorf;3225;2339;30;2309;381;16.50064963
31208;Hausleiten;2939;2110;31;2079;352;16.93121693
31213;Korneuburg;9774;6368;75;6293;873;13.87255681
31214;Langenzersdorf;6357;4281;31;4250;501;11.78823529
31215;Leitzersdorf;992;702;14;688;113;16.4244186
31216;Leobendorf;3867;2781;32;2749;342;12.4408876
31224;Rußbach;1136;816;16;800;134;16.75
31226;Sierndorf;3166;2219;19;2200;323;14.68181818
31227;Spillern;1846;1244;16;1228;208;16.93811075
31228;Stetteldorf am Wagram;823;628;9;619;100;16.15508885
31229;Stetten;1067;740;13;727;136;18.70701513
31230;Stockerau;12593;8050;112;7938;1256;15.82262535
31234;Niederhollabrunn;1242;904;11;893;156;17.46920493
31235;Gerasdorf bei Wien;8541;5757;47;5710;1137;19.91243433
31300;Krems Land;46078;38769;668;38101;5980;15.69512611
31301;Aggsbach;536;357;18;339;46;13.56932153
31302;Albrechtsberg an der Großen Krems;862;628;12;616;102;16.55844156
31303;Bergern im Dunkelsteinerwald;1056;792;18;774;138;17.82945736
31304;Dürnstein;700;515;14;501;47;9.381237525
31308;Grafenegg;2460;1837;27;1810;273;15.08287293
31309;Furth bei Göttweig;2335;1651;27;1624;201;12.37684729
31310;Gedersdorf;1757;1335;24;1311;259;19.75591152
31311;Gföhl;3161;2250;60;2190;411;18.76712329
31315;Hadersdorf-Kammern;1608;1179;29;1150;201;17.47826087
31319;Jaidhof;939;721;18;703;109;15.50497866
31321;Krumau am Kamp;637;472;11;461;89;19.30585683
31322;Langenlois;6107;4221;65;4156;778;18.719923
31323;Lengenfeld;1128;902;12;890;153;17.19101124
31324;Lichtenau im Waldviertel;1705;1219;28;1191;215;18.05205709
31326;Maria Laach am Jauerling;759;585;9;576;83;14.40972222
31327;Mautern an der Donau;2862;1940;35;1905;275;14.43569554
31330;Mühldorf;1112;820;18;802;102;12.71820449
31333;Paudorf;2087;1472;16;1456;250;17.17032967
31336;Rastenfeld;1262;926;30;896;182;20.3125
31337;Rohrendorf bei Krems;1622;1244;14;1230;180;14.63414634
31338;Rossatz-Arnsdorf;908;654;9;645;55;8.527131783
31340;St. Leonhard am Hornerwald;913;679;12;667;119;17.84107946
31343;Senftenberg;1590;1128;18;1110;180;16.21621622
31344;Spitz;1321;911;19;892;111;12.44394619
31346;Straß im Straßertale;1349;1001;17;984;164;16.66666667
31347;Stratzing;695;500;1;499;55;11.02204409
31350;Weinzierl am Walde;1050;758;14;744;127;17.06989247
31351;Weißenkirchen in der Wachau;1208;894;17;877;93;10.60433295
31355;Schönberg am Kamp;1538;1128;12;1116;201;18.01075269
31356;Droß;811;608;14;594;127;21.38047138
31400;Lilienfeld;20144;16479;274;16205;2529;15.60629435
31401;Annaberg;424;252;3;249;31;12.4497992
31402;Eschenau;1033;724;14;710;109;15.35211268
31403;Hainfeld;2959;2000;34;1966;332;16.88708037
31404;Hohenberg;1198;828;15;813;103;12.66912669
31405;Kaumberg;831;596;11;585;150;25.64102564
31406;Kleinzell;674;487;7;480;84;17.5
31407;Lilienfeld;2006;1312;21;1291;193;14.94965143
31408;Mitterbach am Erlaufsee;400;252;1;251;34;13.54581673
31409;Ramsau;646;434;9;425;71;16.70588235
31410;Rohrbach an der Gölsen;1260;908;18;890;145;16.29213483
31411;St. Aegyd am Neuwalde;1553;1054;31;1023;142;13.88074291
31412;St. Veit an der Gölsen;3074;2311;44;2267;363;16.01235112
31413;Traisen;2492;1610;30;1580;312;19.74683544
31414;Türnitz;1594;1057;8;1049;176;16.7778837
31500;Melk;61786;50139;930;49209;8727;17.73456075
31502;Artstetten-Pöbring;965;673;8;665;87;13.08270677
31503;Bergland;1531;1089;17;1072;189;17.63059701
31504;Bischofstetten;983;754;7;747;93;12.4497992
31505;Blindenmarkt;1956;1395;24;1371;373;27.20641867
31506;Dorfstetten;475;342;4;338;85;25.14792899
31507;Dunkelsteinerwald;1967;1427;14;1413;317;22.43453645
31508;Erlauf;875;613;8;605;114;18.84297521
31509;Golling an der Erlauf;1180;803;31;772;199;25.77720207
31511;Hofamt Priel;1382;963;17;946;135;14.27061311
31513;Hürm;1487;977;28;949;145;15.27924131
31514;Kilb;2076;1478;28;1450;204;14.06896552
31515;Kirnberg an der Mank;860;679;6;673;114;16.93907875
31516;Klein-Pöchlarn;833;618;14;604;104;17.21854305
31517;Krummnußbaum;1180;804;10;794;138;17.38035264
31519;Leiben;1099;729;14;715;143;20
31520;Loosdorf;3029;1952;35;1917;378;19.71830986
31521;Mank;2565;1743;21;1722;282;16.37630662
31522;Marbach an der Donau;1347;867;29;838;203;24.22434368
31523;Maria Taferl;711;515;12;503;82;16.30218688
31524;Melk;4143;2711;39;2672;437;16.35479042
31525;Münichreith-Laimbach;1356;912;26;886;190;21.44469526
31527;Neumarkt an der Ybbs;1542;1003;17;986;229;23.22515213
31528;Nöchling;828;580;10;570;84;14.73684211
31530;Persenbeug-Gottsdorf;1791;1124;32;1092;216;19.78021978
31531;Petzenkirchen;1046;704;22;682;148;21.70087977
31533;Pöchlarn;3030;1776;44;1732;333;19.22632794
31534;Pöggstall;2000;1366;31;1335;239;17.90262172
31535;Raxendorf;862;668;19;649;126;19.41448382
31537;Ruprechtshofen;1853;1305;28;1277;272;21.29992169
31539;St. Leonhard am Forst;2483;1739;37;1702;400;23.50176263
31540;St. Martin-Karlsbach;1379;972;19;953;163;17.10388248
31541;St. Oswald;908;628;15;613;61;9.951060359
31542;Schönbühel-Aggsbach;834;586;13;573;117;20.41884817
31543;Schollach;806;574;10;564;125;22.16312057
31546;Weiten;901;531;8;523;87;16.63479924
31549;Ybbs an der Donau;4164;2655;43;2612;441;16.88361409
31550;Zelking-Matzleinsdorf;1005;752;10;742;101;13.61185984
31551;Texingtal;1305;952;20;932;109;11.69527897
31552;Yspertal;1640;1032;27;1005;221;21.99004975
31553;Emmersdorf an der Donau;1409;906;16;890;131;14.71910112
31600;Mistelbach;60948;49872;809;49063;8080;16.46862198
31601;Altlichtenwarth;627;422;6;416;87;20.91346154
31603;Asparn an der Zaya;1485;1106;13;1093;217;19.85361391
31604;Bernhardsthal;1303;942;23;919;143;15.56039173
31605;Bockfließ;1047;816;16;800;111;13.875
31606;Drasenhofen;881;605;6;599;126;21.03505843
31608;Falkenstein;404;308;0;308;24;7.792207792
31609;Fallbach;693;479;5;474;57;12.02531646
31611;Gaubitsch;734;560;14;546;77;14.1025641
31612;Gaweinstal;3102;2132;35;2097;442;21.07773009
31613;Gnadendorf;967;658;17;641;80;12.48049922
31614;Großebersdorf;1784;1341;28;1313;218;16.60319878
31615;Großengersdorf;1125;890;19;871;122;14.00688863
31616;Großharras;957;697;16;681;128;18.7958884
31617;Großkrut;1341;1002;16;986;202;20.48681542
31620;Hausbrunn;683;479;5;474;79;16.66666667
31621;Herrnbaumgarten;765;554;9;545;94;17.24770642
31622;Hochleithen;947;676;6;670;97;14.47761194
31627;Kreuttal;1215;855;18;837;120;14.33691756
31628;Kreuzstetten;1252;857;21;836;139;16.62679426
31629;Laa an der Thaya;5099;3524;64;3460;733;21.1849711
31630;Ladendorf;1876;1272;25;1247;207;16.59983962
31633;Mistelbach;9286;6180;100;6080;999;16.43092105
31634;Neudorf im Weinviertel;1162;835;27;808;199;24.62871287
31636;Niederleis;738;517;11;506;93;18.37944664
31642;Pillichsdorf;930;741;12;729;84;11.52263374
31644;Poysdorf;4364;3037;48;2989;494;16.52726664
31645;Rabensburg;860;523;10;513;122;23.78167641
31646;Schrattenberg;668;478;11;467;73;15.63169165
31649;Staatz;1629;1144;22;1122;204;18.18181818
31650;Stronsdorf;1366;1020;15;1005;223;22.18905473
31651;Ulrichskirchen-Schleinbach;2098;1578;24;1554;235;15.12226512
31652;Unterstinkenbrunn;472;336;7;329;54;16.41337386
31653;Wildendürnbach;1276;925;12;913;153;16.75794085
31654;Wilfersdorf;1731;1238;28;1210;234;19.33884298
31655;Wolkersdorf im Weinviertel;5610;3988;59;3929;415;10.56248409
31658;Ottenthal;471;344;5;339;32;9.439528024
31700;Mödling;89802;73480;582;72898;8765;12.02364948
31701;Achau;1066;703;9;694;116;16.71469741
31702;Biedermannsdorf;2444;1709;14;1695;267;15.75221239
31703;Breitenfurt bei Wien;4666;3257;17;3240;336;10.37037037
31704;Brunn am Gebirge;8746;5916;50;5866;748;12.75144903
31706;Gaaden;1302;956;11;945;84;8.888888889
31707;Gießhübl;1749;1182;5;1177;104;8.836023789
31709;Gumpoldskirchen;2892;2024;13;2011;264;13.12779712
31710;Guntramsdorf;6840;4712;54;4658;805;17.28209532
31711;Hennersdorf;1254;944;7;937;143;15.26147279
31712;Hinterbrühl;2946;1949;13;1936;208;10.74380165
31713;Kaltenleutgeben;2588;1793;15;1778;276;15.52305962
31714;Laab im Walde;896;594;7;587;43;7.325383305
31715;Laxenburg;2149;1398;13;1385;146;10.54151625
31716;Maria Enzersdorf;6542;4100;22;4078;371;9.097596861
31717;Mödling;14930;9283;75;9208;1001;10.87098175
31718;Münchendorf;2269;1557;15;1542;253;16.40726329
31719;Perchtoldsdorf;11762;7815;58;7757;802;10.3390486
31723;Vösendorf;5348;3369;41;3328;653;19.62139423
31725;Wiener Neudorf;7163;4822;46;4776;714;14.94974874
31726;Wienerwald;2250;1703;18;1685;274;16.2611276
31800;Neunkirchen;67903;53654;886;52768;10113;19.16502426
31801;Altendorf;285;206;3;203;32;15.7635468
31802;Aspang-Markt;1528;1044;17;1027;184;17.91626095
31803;Aspangberg-St. Peter;1545;1089;23;1066;208;19.51219512
31804;Breitenau;1274;927;10;917;189;20.61068702
31805;Breitenstein;258;152;2;150;34;22.66666667
31806;Buchbach;293;220;5;215;25;11.62790698
31807;Edlitz;746;529;9;520;82;15.76923077
31808;Enzenreith;1593;1119;19;1100;227;20.63636364
31809;Feistritz am Wechsel;870;646;9;637;129;20.25117739
31810;Gloggnitz;4595;3006;44;2962;669;22.58609048
31811;Grafenbach-St. Valentin;1768;1284;29;1255;265;21.11553785
31812;Grimmenstein;1111;776;18;758;138;18.20580475
31813;Grünbach am Schneeberg;1226;825;9;816;144;17.64705882
31814;Kirchberg am Wechsel;2021;1428;29;1399;294;21.01501072
31815;Mönichkirchen;520;334;5;329;61;18.54103343
31817;Natschbach-Loipersbach;1393;964;22;942;189;20.06369427
31818;Neunkirchen;8932;5431;87;5344;1033;19.33008982
31820;Otterthal;486;349;3;346;87;25.14450867
31821;Payerbach;1651;1054;22;1032;203;19.67054264
31823;Pitten;2276;1476;29;1447;288;19.9032481
31825;Prigglitz;359;243;0;243;53;21.81069959
31826;Puchberg am Schneeberg;2229;1568;28;1540;313;20.32467532
31827;Raach am Hochgebirge;240;191;2;189;39;20.63492063
31829;Reichenau an der Rax;2068;1406;21;1385;248;17.90613718
31830;St. Corona am Wechsel;311;207;3;204;53;25.98039216
31831;St. Egyden am Steinfeld;1582;1111;10;1101;221;20.07266122
31832;Scheiblingkirchen-Thernberg;1571;1089;11;1078;169;15.67717996
31833;Schottwien;525;344;14;330;72;21.81818182
31834;Schrattenbach;305;213;5;208;41;19.71153846
31835;Schwarzau am Steinfeld;1539;1075;20;1055;239;22.65402844
31836;Schwarzau im Gebirge;490;354;23;331;79;23.86706949
31837;Seebenstein;1183;795;26;769;165;21.45643693
31838;Semmering;409;242;5;237;48;20.25316456
31839;Ternitz;11346;7631;155;7476;1491;19.94382022
31840;Thomasberg;1041;777;13;764;173;22.64397906
31841;Trattenbach;439;316;10;306;84;27.45098039
31842;Bürg-Vöstenhof;132;106;1;105;23;21.9047619
31843;Warth;1248;934;13;921;141;15.30944625
31844;Wartmannstetten;1346;1070;11;1059;174;16.4305949
31845;Willendorf;784;525;10;515;106;20.58252427
31846;Wimpassing im Schwarzatale;1169;757;14;743;167;22.47644684
31847;Würflach;1303;875;12;863;142;16.45422943
31848;Zöbern;1181;894;11;883;146;16.53454134
31849;Höflein an der Hohen Wand;732;532;7;525;89;16.95238095
31900;Sankt Pölten Land;101697;83201;1257;81944;12642;15.4276091
31901;Altlengbach;2364;1628;22;1606;309;19.24034869
31902;Asperhofen;1722;1215;17;1198;275;22.95492487
31903;Böheimkirchen;3980;2988;68;2920;527;18.04794521
31904;Brand-Laaben;983;666;11;655;132;20.15267176
31905;Eichgraben;3476;2402;29;2373;304;12.81078803
31906;Frankenfels;1599;1253;32;1221;191;15.64291564
31907;Gerersdorf;768;570;12;558;60;10.75268817
31909;Hofstetten-Grünau;2146;1644;32;1612;283;17.55583127
31910;Hafnerbach;1359;1048;16;1032;170;16.47286822
31911;Haunoldstein;916;663;8;655;123;18.77862595
31912;Herzogenburg;5981;3965;54;3911;740;18.92099207
31913;Inzersdorf-Getzersdorf;1244;899;16;883;163;18.45979615
31915;Kapelln;1103;817;13;804;145;18.03482587
31916;Karlstetten;1779;1309;22;1287;227;17.63791764
31917;Kasten bei Böheimkirchen;1123;897;17;880;117;13.29545455
31918;Kirchberg an der Pielach;2624;1884;45;1839;280;15.22566612
31919;Kirchstetten;1768;1140;22;1118;182;16.27906977
31920;Loich;507;357;6;351;59;16.80911681
31921;Maria-Anzbach;2374;1628;22;1606;235;14.63262765
31922;Markersdorf-Haindorf;1621;1228;12;1216;222;18.25657895
31923;Michelbach;717;551;13;538;91;16.91449814
31925;Neidling;1189;882;12;870;114;13.10344828
31926;Neulengbach;6417;4077;52;4025;635;15.77639752
31927;Neustift-Innermanzing;1249;819;12;807;151;18.71127633
31928;Nußdorf ob der Traisen;1474;1122;26;1096;184;16.78832117
31929;Ober-Grafendorf;3602;2599;42;2557;421;16.46460696
31930;Obritzberg-Rust;1872;1382;22;1360;240;17.64705882
31932;Prinzersdorf;1238;837;12;825;131;15.87878788
31934;Pyhra;2812;2050;38;2012;348;17.29622266
31935;Rabenstein an der Pielach;2044;1500;38;1462;242;16.55266758
31938;St. Margarethen an der Sierning;855;625;11;614;87;14.16938111
31939;Schwarzenbach an der Pielach;321;246;3;243;44;18.10699588
31940;Statzendorf;1108;766;16;750;126;16.8
31941;Stössing;653;443;9;434;78;17.97235023
31943;Traismauer;4722;3394;95;3299;643;19.49075477
31945;Weinburg;1140;829;21;808;137;16.95544554
31946;Perschling;1122;835;16;819;169;20.63492063
31947;Wilhelmsburg;5069;3430;44;3386;612;18.0744241
31948;Wölbling;2007;1444;28;1416;237;16.73728814
31949;Gablitz;3769;2366;25;2341;321;13.71208885
31950;Mauerbach;2832;1944;22;1922;206;10.71800208
31951;Pressbaum;5662;3642;38;3604;519;14.40066593
31952;Purkersdorf;6998;4397;53;4344;553;12.73020258
31953;Tullnerbach;2087;1389;12;1377;140;10.16702977
31954;Wolfsgraben;1301;931;12;919;143;15.56039173
32000;Scheibbs;32997;27533;452;27081;3985;14.71511392
32001;Gaming;2500;1713;37;1676;232;13.8424821
32002;Göstling an der Ybbs;1683;1242;12;1230;161;13.08943089
32003;Gresten;1582;1061;19;1042;134;12.85988484
32004;Gresten-Land;1193;873;14;859;112;13.03841676
32005;Lunz am See;1491;1109;20;1089;154;14.14141414
32006;Oberndorf an der Melk;2414;1825;33;1792;287;16.015625
32007;Puchenstuben;235;167;2;165;27;16.36363636
32008;Purgstall an der Erlauf;4274;2969;46;2923;500;17.10571331
32009;Randegg;1517;1166;35;1131;146;12.90893015
32010;Reinsberg;825;636;3;633;88;13.90205371
32011;St. Anton an der Jeßnitz;971;720;20;700;123;17.57142857
32012;St. Georgen an der Leys;1100;822;19;803;152;18.92901619
32013;Scheibbs;3405;2267;26;2241;236;10.53101294
32014;Steinakirchen am Forst;1831;1361;26;1335;166;12.43445693
32015;Wang;1082;836;19;817;153;18.72705018
32016;Wieselburg;2968;1985;31;1954;338;17.29785056
32017;Wieselburg-Land;2681;1952;30;1922;367;19.09469303
32018;Wolfpassing;1245;975;18;957;210;21.94357367
32100;Tulln;78910;64211;795;63416;9227;14.54995585
32101;Absdorf;1608;1124;16;1108;169;15.25270758
32104;Atzenbrugg;2360;1646;21;1625;309;19.01538462
32106;Fels am Wagram;1889;1329;26;1303;234;17.95855718
32107;Grafenwörth;2579;1757;26;1731;315;18.19757366
32109;Großriedenthal;768;597;10;587;73;12.43611584
32110;Großweikersdorf;2628;1914;39;1875;386;20.58666667
32112;Judenau-Baumgarten;1696;1211;23;1188;228;19.19191919
32114;Kirchberg am Wagram;2945;2174;34;2140;344;16.07476636
32115;Königsbrunn am Wagram;1050;782;15;767;118;15.38461538
32116;Königstetten;1870;1382;16;1366;194;14.20204978
32119;Langenrohr;1790;1288;15;1273;254;19.95286724
32120;Michelhausen;2491;1657;39;1618;240;14.83312732
32131;Sieghartskirchen;5760;4135;67;4068;778;19.12487709
32132;Sitzenberg-Reidling;1765;1238;19;1219;245;20.09844135
32134;Tulbing;2405;1707;17;1690;254;15.0295858
32135;Tulln an der Donau;11870;7812;107;7705;1175;15.24983777
32139;Würmla;1135;829;15;814;149;18.3046683
32140;Zeiselmauer-Wolfpassing;1787;1245;23;1222;200;16.36661211
32141;Zwentendorf an der Donau;2971;2126;38;2088;393;18.82183908
32142;St. Andrä-Wördern;6036;4131;44;4087;605;14.80303401
32143;Muckendorf-Wipfing;1311;927;9;918;169;18.40958606
32144;Klosterneuburg;20196;13708;118;13590;1371;10.08830022
32200;Waidhofen an der Thaya;21927;17542;330;17212;3175;18.44643272
32202;Dietmanns;922;593;7;586;171;29.18088737
32203;Dobersberg;1331;913;10;903;159;17.60797342
32206;Gastern;1039;766;12;754;146;19.36339523
32207;Groß-Siegharts;2318;1365;34;1331;299;22.46431255
32209;Karlstein an der Thaya;1215;877;16;861;175;20.32520325
32210;Kautzen;944;672;11;661;121;18.30559758
32212;Ludweis-Aigen;762;530;10;520;70;13.46153846
32214;Pfaffenschlag bei Waidhofen a.d.Thaya;780;564;8;556;130;23.38129496
32216;Raabs an der Thaya;2300;1557;37;1520;215;14.14473684
32217;Thaya;1164;799;11;788;189;23.98477157
32219;Vitis;2224;1556;44;1512;257;16.9973545
32220;Waidhofen an der Thaya;4599;2847;57;2790;547;19.60573477
32221;Waidhofen an der Thaya-Land;1056;727;19;708;154;21.75141243
32222;Waldkirchen an der Thaya;457;342;5;337;45;13.35311573
32223;Windigsteig;816;575;11;564;98;17.37588652
32300;Wiener Neustadt Land;60568;48331;725;47606;9482;19.91765744
32301;Bad Fischau-Brunn;2651;1923;16;1907;313;16.41321447
32302;Bad Schönau;604;425;6;419;99;23.62768496
32304;Ebenfurth;2130;1300;21;1279;265;20.71931196
32305;Eggendorf;3724;2530;38;2492;646;25.92295345
32306;Bad Erlach;2513;1724;34;1690;320;18.93491124
32307;Felixdorf;3231;2151;26;2125;413;19.43529412
32308;Gutenstein;1030;675;11;664;128;19.27710843
32309;Hochneukirchen-Gschaidt;1398;1074;21;1053;221;20.98765432
32310;Hochwolkersdorf;848;640;7;633;96;15.16587678
32311;Hohe Wand;1128;794;7;787;148;18.80559085
32312;Hollenthon;820;660;23;637;120;18.83830455
32313;Katzelsdorf;2594;1812;21;1791;302;16.86208822
32314;Kirchschlag in der Buckligen Welt;2329;1784;35;1749;296;16.92395655
32315;Krumbach;1873;1432;23;1409;259;18.38183109
32316;Lanzenkirchen;3108;2192;42;2150;495;23.02325581
32317;Lichtenegg;870;631;25;606;80;13.20132013
32318;Lichtenwörth;2164;1439;17;1422;321;22.57383966
32319;Markt Piesting;2226;1560;20;1540;286;18.57142857
32320;Matzendorf-Hölles;1658;1150;20;1130;255;22.56637168
32321;Miesenbach;553;406;3;403;78;19.35483871
32322;Muggendorf;427;336;9;327;62;18.96024465
32323;Pernitz;1916;1299;20;1279;277;21.65754496
32324;Rohr im Gebirge;368;259;6;253;42;16.60079051
32325;Bromberg;956;713;12;701;121;17.26105563
32326;Schwarzenbach;773;594;13;581;102;17.55593804
32327;Sollenau;3876;2566;28;2538;639;25.17730496
32330;Theresienfeld;2452;1612;20;1592;369;23.17839196
32331;Waidmannsfeld;1252;885;20;865;140;16.1849711
32332;Waldegg;1498;1017;13;1004;179;17.82868526
32333;Walpersbach;916;676;16;660;105;15.90909091
32334;Weikersdorf am Steinfelde;866;667;7;660;143;21.66666667
32335;Wiesmath;1251;960;19;941;184;19.55366631
32336;Winzendorf-Muthmannsdorf;1509;1004;14;990;182;18.38383838
32337;Wöllersdorf-Steinabrückl;3420;2202;29;2173;595;27.38150023
32338;Zillingdorf;1636;1179;15;1164;262;22.50859107
32500;Zwettl;35413;29412;579;28833;4852;16.82794021
32501;Allentsteig;1563;1032;22;1010;240;23.76237624
32502;Arbesbach;1369;1032;33;999;148;14.81481481
32503;Bärnkopf;304;240;4;236;41;17.37288136
32504;Echsenbach;1031;764;9;755;126;16.68874172
32505;Göpfritz an der Wild;1539;1109;19;1090;246;22.56880734
32506;Grafenschlag;704;527;15;512;88;17.1875
32508;Groß Gerungs;3735;2743;66;2677;437;16.32424356
32509;Großgöttfritz;1150;871;15;856;211;24.64953271
32511;Gutenbrunn;442;327;7;320;55;17.1875
32514;Kirchschlag;536;406;8;398;88;22.11055276
32515;Kottes-Purk;1222;860;23;837;125;14.93428913
32516;Langschlag;1434;1051;33;1018;203;19.9410609
32517;Martinsberg;907;655;14;641;118;18.40873635
32518;Ottenschlag;843;607;13;594;119;20.03367003
32519;Altmelon;714;547;11;536;120;22.3880597
32520;Pölla;773;540;11;529;132;24.95274102
32521;Rappottenstein;1430;1023;27;996;169;16.96787149
32522;Sallingberg;1053;746;16;730;149;20.4109589
32523;Schönbach;667;494;12;482;80;16.59751037
32524;Schwarzenau;1267;935;16;919;152;16.53971708
32525;Schweiggers;1640;1236;13;1223;209;17.0891251
32528;Bad Traunstein;833;625;8;617;90;14.58670989
32529;Waldhausen;1005;741;10;731;123;16.82626539
32530;Zwettl-Niederösterreich;9252;6214;124;6090;860;14.12151067
40000;Oberösterreich;1104436;858039;12943;845096;147873;17.4977754
40100;Linz Stadt;138154;97157;957;96200;13464;13.995842
40101;Linz;138154;73739;800;72939;11252;15.42658934
40200;Steyr Stadt;27006;19588;243;19345;3300;17.05867149
40201;Steyr;27006;16521;226;16295;2959;18.15894446
40300;Wels Stadt;39157;27272;369;26903;5322;19.78218043
40301;Wels;39157;22631;342;22289;4636;20.79949751
40400;Braunau am Inn;76045;55816;865;54951;11462;20.8585831
40401;Altheim;3770;2356;42;2314;599;25.88591184
40402;Aspach;1998;1176;16;1160;293;25.25862069
40403;Auerbach;449;312;5;307;91;29.64169381
40404;Braunau am Inn;11603;6271;85;6186;1220;19.7219528
40405;Burgkirchen;2080;1326;21;1305;290;22.22222222
40406;Eggelsberg;1852;1095;19;1076;256;23.79182156
40407;Feldkirchen bei Mattighofen;1604;1074;15;1059;300;28.3286119
40408;Franking;780;440;7;433;88;20.32332564
40409;Geretsberg;873;550;6;544;120;22.05882353
40410;Gilgenberg am Weilhart;1041;658;6;652;161;24.69325153
40411;Haigermoos;486;327;5;322;60;18.63354037
40412;Handenberg;1024;691;14;677;135;19.94091581
40413;Helpfau-Uttendorf;2369;1411;22;1389;326;23.47012239
40414;Hochburg-Ach;2211;1329;21;1308;187;14.29663609
40415;Höhnhart;1113;645;11;634;164;25.86750789
40416;Jeging;511;357;13;344;80;23.25581395
40417;Kirchberg bei Mattighofen;932;618;11;607;136;22.40527183
40418;Lengau;3611;2243;64;2179;445;20.42221202
40419;Lochen am See;2183;1480;28;1452;331;22.79614325
40420;Maria Schmolln;1180;735;10;725;123;16.96551724
40421;Mattighofen;3753;2094;33;2061;451;21.88258127
40422;Mauerkirchen;1645;845;7;838;210;25.05966587
40423;Mining;982;616;4;612;109;17.81045752
40424;Moosbach;773;499;10;489;165;33.74233129
40425;Moosdorf;1295;823;13;810;187;23.08641975
40426;Munderfing;2276;1416;34;1382;295;21.34587554
40427;Neukirchen an der Enknach;1748;1150;21;1129;270;23.914969
40428;Ostermiething;2435;1413;31;1382;232;16.78726483
40429;Palting;796;514;11;503;117;23.26043738
40430;Perwang am Grabensee;783;510;3;507;102;20.1183432
40431;Pfaffstätt;784;523;7;516;87;16.86046512
40432;Pischelsdorf am Engelbach;1276;826;12;814;215;26.41277641
40433;Polling im Innkreis;767;479;11;468;144;30.76923077
40434;Roßbach;752;487;10;477;130;27.25366876
40435;St. Georgen am Fillmannsbach;343;236;3;233;93;39.91416309
40436;St. Johann am Walde;1639;987;18;969;221;22.80701754
40437;St. Pantaleon;2306;1357;20;1337;252;18.84816754
40438;St. Peter am Hart;1811;1020;17;1003;179;17.84646062
40439;St. Radegund;462;327;3;324;28;8.641975309
40440;St. Veit im Innkreis;319;223;4;219;51;23.28767123
40441;Schalchen;2872;1818;33;1785;354;19.83193277
40442;Schwand im Innkreis;767;503;7;496;101;20.36290323
40443;Tarsdorf;1632;1017;13;1004;200;19.92031873
40444;Treubach;574;344;4;340;90;26.47058824
40445;Überackern;441;250;1;249;53;21.28514056
40446;Weng im Innkreis;1144;705;12;693;201;29.004329
40500;Eferding;25869;20908;445;20463;4030;19.694082
40501;Alkoven;4639;3273;45;3228;606;18.7732342
40502;Aschach an der Donau;1595;1018;14;1004;206;20.51792829
40503;Eferding;2927;1797;22;1775;323;18.1971831
40504;Fraham;1871;1170;16;1154;216;18.71750433
40505;Haibach ob der Donau;1095;743;14;729;123;16.87242798
40506;Hartkirchen;3384;2426;38;2388;567;23.74371859
40507;Hinzenbach;1620;1096;21;1075;202;18.79069767
40508;Prambachkirchen;2276;1473;22;1451;318;21.91592006
40509;Pupping;1455;981;10;971;228;23.48094748
40510;St. Marienkirchen an der Polsenz;1899;1288;20;1268;272;21.4511041
40511;Scharten;1772;1229;19;1210;292;24.1322314
40512;Stroheim;1336;921;19;902;186;20.62084257
40600;Freistadt;53816;44628;851;43777;6770;15.46474176
40601;Freistadt;6134;4074;69;4005;641;16.00499376
40602;Grünbach;1572;985;17;968;193;19.93801653
40603;Gutau;2237;1601;17;1584;238;15.02525253
40604;Hagenberg im Mühlkreis;2249;1455;20;1435;253;17.63066202
40605;Hirschbach im Mühlkreis;958;630;6;624;60;9.615384615
40606;Kaltenberg;499;425;4;421;65;15.43942993
40607;Kefermarkt;1713;1209;29;1180;194;16.44067797
40608;Königswiesen;2511;1730;30;1700;331;19.47058824
40609;Lasberg;2328;1640;32;1608;223;13.8681592
40610;Leopoldschlag;832;599;21;578;92;15.91695502
40611;Liebenau;1335;908;20;888;143;16.1036036
40612;Neumarkt im Mühlkreis;2581;1781;43;1738;239;13.75143843
40613;Pierbach;805;596;20;576;132;22.91666667
40614;Pregarten;4415;3012;55;2957;522;17.65302672
40615;Rainbach im Mühlkreis;2349;1553;43;1510;183;12.1192053
40616;Sandl;1152;834;21;813;124;15.25215252
40617;St. Leonhard bei Freistadt;1153;816;13;803;120;14.94396015
40618;St. Oswald bei Freistadt;2328;1599;41;1558;285;18.29268293
40619;Schönau im Mühlkreis;1567;1199;27;1172;193;16.46757679
40620;Tragwein;2498;1803;27;1776;280;15.76576577
40621;Unterweißenbach;1775;1223;26;1197;241;20.1336675
40622;Unterweitersdorf;1757;1242;30;1212;179;14.7689769
40623;Waldburg;1120;762;7;755;109;14.43708609
40624;Wartberg ob der Aist;3516;2316;32;2284;397;17.38178634
40625;Weitersfelden;826;574;15;559;71;12.70125224
40626;Windhaag bei Freistadt;1263;863;22;841;91;10.82045184
40627;Bad Zell;2343;1693;43;1650;256;15.51515152
40700;Gmunden;78454;60820;1068;59752;9327;15.60951935
40701;Altmünster;7779;4960;112;4848;721;14.87211221
40702;Bad Goisern am Hallstättersee;6157;3730;102;3628;584;16.09702315
40703;Bad Ischl;10750;6076;117;5959;904;15.17033059
40704;Ebensee am Traunsee;6260;4085;80;4005;694;17.32833958
40705;Gmunden;9732;5449;78;5371;789;14.69000186
40706;Gosau;1427;927;36;891;110;12.34567901
40707;Grünau im Almtal;1622;1033;19;1014;210;20.71005917
40708;Gschwandt;2230;1532;21;1511;258;17.07478491
40709;Hallstatt;579;385;5;380;32;8.421052632
40710;Kirchham;1724;1120;24;1096;221;20.16423358
40711;Laakirchen;7075;4419;92;4327;768;17.7490178
40712;Obertraun;552;378;10;368;18;4.891304348
40713;Ohlsdorf;4074;2623;49;2574;512;19.89121989
40714;Pinsdorf;3018;1867;39;1828;376;20.56892779
40715;Roitham am Traunfall;1581;986;12;974;218;22.38193018
40716;St. Konrad;896;616;7;609;110;18.06239737
40717;St. Wolfgang im Salzkammergut;2126;1276;18;1258;157;12.48012719
40718;Traunkirchen;1351;833;12;821;78;9.500609013
40719;Scharnstein;3774;2361;41;2320;415;17.88793103
40720;Vorchdorf;5747;3810;54;3756;771;20.52715655
40800;Grieskirchen;50592;40380;710;39670;8057;20.31005798
40801;Aistersheim;714;441;10;431;125;29.00232019
40802;Bad Schallerbach;3086;1794;21;1773;371;20.9249859
40804;Eschenau im Hausruckkreis;897;663;18;645;137;21.24031008
40805;Gallspach;1838;1079;10;1069;297;27.78297474
40806;Gaspoltshofen;2842;1661;47;1614;422;26.14622057
40807;Geboltskirchen;1160;792;15;777;148;19.04761905
40808;Grieskirchen;3522;2160;36;2124;426;20.05649718
40809;Haag am Hausruck;1662;1080;14;1066;200;18.76172608
40810;Heiligenberg;569;449;4;445;94;21.12359551
40811;Hofkirchen an der Trattnach;1241;821;18;803;182;22.66500623
40812;Kallham;2060;1250;28;1222;256;20.9492635
40813;Kematen am Innbach;1079;726;15;711;216;30.37974684
40814;Meggenhofen;1187;785;22;763;121;15.85845347
40815;Michaelnbach;1034;637;14;623;107;17.17495987
40816;Natternbach;1870;1272;32;1240;247;19.91935484
40817;Neukirchen am Walde;1334;971;14;957;204;21.31661442
40818;Neumarkt im Hausruckkreis;1101;649;11;638;153;23.98119122
40820;Pötting;455;333;2;331;46;13.89728097
40821;Pollham;788;478;10;468;73;15.5982906
40822;Pram;1351;836;17;819;225;27.47252747
40823;Rottenbach;846;557;13;544;174;31.98529412
40824;St. Agatha;1746;1223;27;1196;232;19.39799331
40825;St. Georgen bei Grieskirchen;1084;700;9;691;137;19.82633864
40826;St. Thomas;432;301;5;296;56;18.91891892
40827;Schlüßlberg;2377;1572;27;1545;281;18.18770227
40828;Steegen;916;555;9;546;107;19.5970696
40829;Taufkirchen an der Trattnach;1612;1044;16;1028;271;26.3618677
40830;Tollet;762;511;5;506;83;16.40316206
40831;Waizenkirchen;2918;1976;24;1952;396;20.28688525
40832;Wallern an der Trattnach;2392;1552;23;1529;326;21.32112492
40833;Weibern;1300;828;20;808;120;14.85148515
40834;Wendling;688;439;5;434;109;25.11520737
40835;Peuerbach;3729;2339;31;2308;440;19.06412478
40900;Kirchdorf an der Krems;43478;33808;504;33304;6223;18.68544319
40901;Edlbach;503;316;3;313;51;16.29392971
40902;Grünburg;2940;1746;32;1714;389;22.69544924
40903;Hinterstoder;720;446;7;439;89;20.27334852
40904;Inzersdorf im Kremstal;1507;956;26;930;183;19.67741935
40905;Kirchdorf an der Krems;3267;1940;26;1914;288;15.04702194
40906;Klaus an der Pyhrnbahn;805;531;14;517;87;16.827853
40907;Kremsmünster;4708;2963;42;2921;519;17.76788771
40908;Micheldorf in Oberösterreich;4513;2917;37;2880;514;17.84722222
40909;Molln;2773;1811;28;1783;359;20.1346046
40910;Nußbach;1833;1231;13;1218;158;12.97208539
40911;Oberschlierbach;369;265;2;263;29;11.02661597
40912;Pettenbach;4057;2685;48;2637;661;25.06636329
40913;Ried im Traunkreis;2158;1430;20;1410;333;23.61702128
40914;Rosenau am Hengstpaß;491;306;4;302;64;21.19205298
40915;Roßleithen;1485;907;18;889;186;20.9223847
40916;St. Pankraz;278;176;3;173;67;38.7283237
40917;Schlierbach;2183;1416;15;1401;260;18.55817273
40918;Spital am Pyhrn;1758;1061;10;1051;267;25.40437678
40919;Steinbach am Ziehberg;686;451;7;444;79;17.79279279
40920;Steinbach an der Steyr;1603;1092;11;1081;181;16.74375578
40921;Vorderstoder;662;408;12;396;81;20.45454545
40922;Wartberg an der Krems;2304;1502;21;1481;260;17.5557056
40923;Windischgarsten;1875;1087;23;1064;193;18.13909774
41000;Linz-Land;107635;83273;1067;82206;13863;16.86373257
41001;Allhaming;928;637;6;631;112;17.7496038
41002;Ansfelden;10867;6569;94;6475;1649;25.46718147
41003;Asten;4672;2994;44;2950;648;21.96610169
41004;Eggendorf im Traunkreis;748;490;4;486;85;17.48971193
41005;Enns;7954;4996;56;4940;782;15.82995951
41006;Hargelsberg;1074;758;9;749;114;15.22029372
41007;Hörsching;4546;2996;46;2950;594;20.13559322
41008;Hofkirchen im Traunkreis;1433;942;19;923;150;16.25135428
41009;Kematen an der Krems;2086;1315;20;1295;258;19.92277992
41010;Kirchberg-Thening;1961;1333;11;1322;216;16.33888048
41011;Kronstorf;2683;1830;32;1798;296;16.46273637
41012;Leonding;20907;12991;150;12841;1989;15.48944786
41013;St. Florian;5025;3256;47;3209;465;14.49049548
41014;Neuhofen an der Krems;4974;2830;40;2790;429;15.37634409
41015;Niederneukirchen;1675;1103;10;1093;199;18.20677036
41016;Oftering;1647;1144;12;1132;213;18.81625442
41017;Pasching;5468;3726;56;3670;626;17.05722071
41018;Piberbach;1475;934;14;920;158;17.17391304
41019;Pucking;3157;2067;40;2027;522;25.75234336
41020;St. Marien;3785;2468;41;2427;377;15.53358055
41021;Traun;15940;9335;128;9207;1748;18.98555447
41022;Wilhering;4630;3126;33;3093;332;10.73391529
41100;Perg;52899;43095;793;42302;6831;16.14817266
41101;Allerheiligen im Mühlkreis;1021;753;14;739;126;17.05006766
41102;Arbing;1158;813;13;800;127;15.875
41103;Baumgartenberg;1364;942;18;924;230;24.89177489
41104;Dimbach;811;542;16;526;94;17.87072243
41105;Grein;2296;1436;28;1408;260;18.46590909
41106;Katsdorf;2525;1689;33;1656;203;12.25845411
41107;Klam;761;462;7;455;128;28.13186813
41108;Bad Kreuzen;1781;1148;24;1124;175;15.56939502
41109;Langenstein;1951;1369;19;1350;217;16.07407407
41110;Luftenberg an der Donau;3320;2179;41;2138;374;17.4929841
41111;Mauthausen;3641;2324;37;2287;343;14.99781373
41112;Mitterkirchen im Machland;1350;892;17;875;154;17.6
41113;Münzbach;1309;961;41;920;184;20
41114;Naarn im Machlande;2799;2002;27;1975;327;16.55696203
41115;Pabneukirchen;1329;903;20;883;177;20.04530011
41116;Perg;6364;4097;66;4031;719;17.83676507
41117;Rechberg;751;549;9;540;55;10.18518519
41118;Ried in der Riedmark;3410;2357;47;2310;330;14.28571429
41119;St. Georgen am Walde;1622;1121;29;1092;198;18.13186813
41120;St. Georgen an der Gusen;3279;2231;38;2193;290;13.22389421
41121;St. Nikola an der Donau;563;375;8;367;44;11.98910082
41122;St. Thomas am Blasenstein;739;505;7;498;62;12.4497992
41123;Saxen;1381;964;26;938;228;24.30703625
41124;Schwertberg;3957;2668;46;2622;413;15.75133486
41125;Waldhausen im Strudengau;2285;1558;39;1519;253;16.65569454
41126;Windhaag bei Perg;1132;769;15;754;119;15.78249337
41200;Ried im Innkreis;46593;35635;513;35122;7882;22.44177439
41201;Andrichsfurt;605;392;6;386;86;22.27979275
41202;Antiesenhofen;813;451;9;442;119;26.92307692
41203;Aurolzmünster;2249;1260;18;1242;374;30.11272142
41204;Eberschwang;2719;1644;41;1603;407;25.38989395
41205;Eitzing;655;399;6;393;97;24.68193384
41206;Geiersberg;423;255;3;252;58;23.01587302
41207;Geinberg;1052;527;7;520;136;26.15384615
41208;Gurten;929;554;4;550;144;26.18181818
41209;Hohenzell;1797;1156;24;1132;215;18.99293286
41210;Kirchdorf am Inn;504;345;6;339;75;22.12389381
41211;Kirchheim im Innkreis;587;407;10;397;98;24.68513854
41212;Lambrechten;1077;700;7;693;195;28.13852814
41213;Lohnsburg am Kobernaußerwald;1818;1117;18;1099;275;25.02274795
41214;Mehrnbach;1856;1065;7;1058;296;27.97731569
41215;Mettmach;1917;1204;29;1175;390;33.19148936
41216;Mörschwang;271;179;3;176;25;14.20454545
41217;Mühlheim am Inn;520;346;4;342;79;23.0994152
41218;Neuhofen im Innkreis;1925;1197;18;1179;225;19.08396947
41219;Obernberg am Inn;1148;555;5;550;153;27.81818182
41220;Ort im Innkreis;921;585;5;580;162;27.93103448
41221;Pattigham;756;469;3;466;123;26.39484979
41222;Peterskirchen;577;395;6;389;79;20.30848329
41223;Pramet;834;522;2;520;137;26.34615385
41224;Reichersberg;1149;678;13;665;162;24.36090226
41225;Ried im Innkreis;8345;4542;49;4493;982;21.85622079
41226;St. Georgen bei Obernberg am Inn;454;312;1;311;41;13.18327974
41227;St. Marienkirchen am Hausruck;676;510;5;505;115;22.77227723
41228;St. Martin im Innkreis;1345;702;11;691;168;24.31259045
41229;Schildorn;962;583;14;569;102;17.92618629
41230;Senftenbach;618;345;10;335;75;22.3880597
41231;Taiskirchen im Innkreis;1931;1288;27;1261;267;21.17367169
41232;Tumeltsham;1265;751;11;740;162;21.89189189
41233;Utzenaich;1199;771;19;752;159;21.14361702
41234;Waldzell;1766;1136;17;1119;275;24.57551385
41235;Weilbach;482;321;4;317;67;21.13564669
41236;Wippenham;448;294;7;287;58;20.20905923
41300;Rohrbach;45513;36691;613;36078;5947;16.4837297
41304;Altenfelden;1804;1225;28;1197;272;22.72347536
41305;Arnreit;909;693;12;681;113;16.59324523
41306;Atzesberg;369;292;5;287;65;22.64808362
41307;Auberg;427;311;5;306;59;19.28104575
41309;Haslach an der Mühl;2074;1382;30;1352;196;14.49704142
41311;Hörbich;325;260;5;255;55;21.56862745
41312;Hofkirchen im Mühlkreis;1206;751;15;736;116;15.76086957
41313;Julbach;1283;846;27;819;133;16.23931624
41314;Kirchberg ob der Donau;861;581;8;573;85;14.83420593
41315;Klaffer am Hochficht;1054;677;9;668;169;25.2994012
41316;Kleinzell im Mühlkreis;1312;878;15;863;120;13.90498262
41317;Kollerschlag;1192;839;12;827;201;24.30471584
41318;Lembach im Mühlkreis;1235;784;15;769;167;21.71651495
41319;Lichtenau im Mühlkreis;404;238;6;232;51;21.98275862
41320;Nebelberg;497;385;5;380;33;8.684210526
41321;Neufelden;931;588;10;578;81;14.01384083
41322;Niederkappel;789;562;19;543;102;18.78453039
41323;Niederwaldkirchen;1456;968;6;962;147;15.28066528
41324;Oberkappel;527;313;7;306;42;13.7254902
41325;Oepping;1311;890;16;874;157;17.96338673
41326;Peilstein im Mühlviertel;1268;895;18;877;120;13.68301026
41327;Pfarrkirchen im Mühlkreis;1161;802;12;790;124;15.69620253
41328;Putzleinsdorf;1253;857;10;847;140;16.52892562
41329;Neustift im Mühlkreis;1146;774;14;760;93;12.23684211
41331;St. Johann am Wimberg;815;534;15;519;113;21.77263969
41332;St. Martin im Mühlkreis;2970;2030;33;1997;331;16.57486229
41333;St. Oswald bei Haslach;391;268;4;264;49;18.56060606
41334;St. Peter am Wimberg;1455;1037;11;1026;107;10.4288499
41336;St. Ulrich im Mühlkreis;511;347;2;345;49;14.20289855
41337;St. Veit im Mühlkreis;983;713;10;703;130;18.49217639
41338;Sarleinsbach;1839;1329;23;1306;201;15.39050536
41341;Schwarzenberg am Böhmerwald;457;326;7;319;51;15.98746082
41342;Ulrichsberg;2349;1503;29;1474;301;20.42062415
41343;Aigen-Schlägl;2618;1565;25;1540;272;17.66233766
41344;Rohrbach-Berg;4159;2587;45;2542;401;15.77498033
41345;Helfenberg;1263;890;11;879;162;18.43003413
41346;St. Stefan-Afiesl;909;646;14;632;107;16.93037975
41400;Schärding;44551;34934;484;34450;7941;23.05079826
41401;Altschwendt;543;391;8;383;78;20.36553525
41402;Andorf;4103;2850;39;2811;747;26.57417289
41403;Brunnenthal;1566;984;12;972;247;25.41152263
41404;Diersbach;1310;844;9;835;211;25.26946108
41405;Dorf an der Pram;854;575;7;568;96;16.90140845
41406;Eggerding;1053;658;11;647;146;22.56568779
41407;Engelhartszell;764;391;4;387;94;24.28940568
41408;Enzenkirchen;1442;971;17;954;301;31.55136268
41409;Esternberg;2347;1540;25;1515;361;23.82838284
41410;Freinberg;996;560;1;559;107;19.14132379
41411;Kopfing im Innkreis;1625;1104;24;1080;303;28.05555556
41412;Mayrhof;249;176;2;174;54;31.03448276
41413;Münzkirchen;2091;1386;13;1373;332;24.18062637
41414;Raab;1819;1138;13;1125;345;30.66666667
41415;Rainbach im Innkreis;1187;830;11;819;213;26.00732601
41416;Riedau;1586;918;13;905;200;22.09944751
41417;St. Aegidi;1290;918;12;906;230;25.38631347
41418;St. Florian am Inn;2333;1434;14;1420;351;24.71830986
41419;St. Marienkirchen bei Schärding;1454;903;18;885;233;26.32768362
41420;St. Roman;1427;984;11;973;252;25.89928058
41421;St. Willibald;931;668;14;654;178;27.21712538
41422;Schärding;3704;1972;19;1953;425;21.76139273
41423;Schardenberg;1707;1128;11;1117;230;20.5908684
41424;Sigharting;678;497;19;478;124;25.94142259
41425;Suben;951;563;8;555;111;20
41426;Taufkirchen an der Pram;2311;1515;18;1497;387;25.85170341
41427;Vichtenstein;446;299;3;296;67;22.63513514
41428;Waldkirchen am Wesen;1003;682;23;659;134;20.33383915
41429;Wernstein am Inn;1210;742;7;735;172;23.40136054
41430;Zell an der Pram;1571;1003;26;977;181;18.52610031
41500;Steyr-Land;48132;39228;580;38648;6321;16.35530946
41501;Adlwang;1473;957;19;938;174;18.55010661
41502;Aschach an der Steyr;1899;1279;20;1259;201;15.96505163
41503;Bad Hall;4034;2253;26;2227;375;16.83879659
41504;Dietach;2484;1734;14;1720;267;15.52325581
41505;Gaflenz;1536;1062;17;1045;164;15.6937799
41506;Garsten;5172;3397;68;3329;547;16.43136077
41507;Großraming;2166;1499;36;1463;221;15.10594668
41508;Laussa;1014;691;6;685;131;19.12408759
41509;Losenstein;1305;814;11;803;142;17.68368618
41510;Maria Neustift;1288;907;19;888;174;19.59459459
41511;Pfarrkirchen bei Bad Hall;1825;1281;15;1266;226;17.85150079
41512;Reichraming;1447;971;14;957;160;16.71891327
41513;Rohr im Kremstal;1073;672;5;667;113;16.94152924
41514;St. Ulrich bei Steyr;2530;1652;17;1635;271;16.57492355
41515;Schiedlberg;1015;662;8;654;84;12.8440367
41516;Sierning;7343;4866;89;4777;858;17.96106343
41517;Ternberg;2777;1788;27;1761;320;18.17149347
41518;Waldneukirchen;1768;1218;13;1205;206;17.09543568
41521;Wolfern;2605;1665;25;1640;298;18.17073171
41522;Weyer;3378;2208;31;2177;378;17.36334405
41600;Urfahr-Umgebung;68781;57457;873;56584;7596;13.42428955
41601;Alberndorf in der Riedmark;3291;2120;32;2088;388;18.58237548
41602;Altenberg bei Linz;3674;2540;34;2506;330;13.16839585
41603;Bad Leonfelden;3332;2136;51;2085;343;16.45083933
41604;Eidenberg;1696;1208;28;1180;128;10.84745763
41605;Engerwitzdorf;7027;4717;85;4632;693;14.9611399
41606;Feldkirchen an der Donau;4412;2982;49;2933;538;18.34299352
41607;Gallneukirchen;5242;3259;46;3213;365;11.3600996
41608;Goldwörth;693;470;5;465;75;16.12903226
41609;Gramastetten;4143;2661;46;2615;332;12.6959847
41610;Haibach im Mühlkreis;749;508;12;496;78;15.72580645
41611;Hellmonsödt;1890;1182;15;1167;181;15.50985433
41612;Herzogsdorf;2164;1389;28;1361;261;19.17707568
41613;Kirchschlag bei Linz;1721;1148;18;1130;172;15.22123894
41614;Lichtenberg;2178;1520;20;1500;175;11.66666667
41615;Oberneukirchen;2596;1721;39;1682;250;14.86325803
41616;Ottenschlag im Mühlkreis;433;305;7;298;61;20.46979866
41617;Ottensheim;3725;2370;13;2357;249;10.56427662
41618;Puchenau;3648;2273;20;2253;244;10.83000444
41619;Reichenau im Mühlkreis;1031;692;15;677;98;14.47562777
41620;Reichenthal;1201;822;16;806;93;11.53846154
41621;St. Gotthard im Mühlkreis;1054;731;16;715;102;14.26573427
41622;Schenkenfelden;1303;882;13;869;110;12.65822785
41623;Sonnberg im Mühlkreis;794;529;12;517;82;15.86073501
41624;Steyregg;3881;2536;32;2504;376;15.01597444
41626;Walding;3378;2168;37;2131;233;10.93383388
41627;Zwettl an der Rodl;1364;933;22;911;102;11.19648738
41628;Vorderweißenbach;2161;1517;38;1479;237;16.02434077
41700;Vöcklabruck;102974;80479;1362;79117;14207;17.95694983
41701;Ampflwang im Hausruckwald;2560;1656;26;1630;311;19.0797546
41702;Attersee am Attersee;1277;754;6;748;112;14.97326203
41703;Attnang-Puchheim;5672;3128;36;3092;620;20.05174644
41704;Atzbach;966;661;15;646;128;19.81424149
41705;Aurach am Hongar;1373;933;21;912;218;23.90350877
41706;Berg im Attergau;827;574;8;566;94;16.60777385
41707;Desselbrunn;1412;920;11;909;173;19.03190319
41708;Fornach;758;557;23;534;93;17.41573034
41709;Frankenburg am Hausruck;3933;2715;65;2650;616;23.24528302
41710;Frankenmarkt;2681;1736;47;1689;323;19.12374186
41711;Gampern;2338;1666;50;1616;260;16.08910891
41712;Innerschwand am Mondsee;915;540;8;532;58;10.90225564
41713;Lenzing;3925;2415;42;2373;589;24.82090181
41714;Manning;654;429;8;421;62;14.72684086
41715;Mondsee;2600;1361;13;1348;207;15.35608309
41716;Neukirchen an der Vöckla;2111;1485;35;1450;288;19.86206897
41717;Niederthalheim;841;583;19;564;106;18.79432624
41718;Nußdorf am Attersee;894;503;5;498;93;18.6746988
41719;Oberhofen am Irrsee;1248;813;12;801;120;14.98127341
41720;Oberndorf bei Schwanenstadt;1097;750;18;732;186;25.40983607
41721;Oberwang;1377;855;17;838;182;21.71837709
41722;Ottnang am Hausruck;3037;1925;50;1875;456;24.32
41723;Pfaffing;1185;799;23;776;143;18.42783505
41724;Pilsbach;521;361;3;358;44;12.29050279
41725;Pitzenberg;448;295;6;289;56;19.37716263
41726;Pöndorf;1878;1175;22;1153;251;21.76929748
41727;Puchkirchen am Trattberg;814;517;16;501;75;14.97005988
41728;Pühret;496;341;14;327;72;22.01834862
41729;Redleiten;401;265;10;255;82;32.15686275
41730;Redlham;1293;859;21;838;172;20.52505967
41731;Regau;5020;3391;53;3338;723;21.65967645
41732;Rüstorf;1678;1034;22;1012;229;22.6284585
41733;Rutzenham;222;168;1;167;26;15.56886228
41734;St. Georgen im Attergau;3173;1919;27;1892;437;23.09725159
41735;St. Lorenz;1890;1122;22;1100;163;14.81818182
41736;Schlatt;1093;651;16;635;111;17.48031496
41737;Schörfling am Attersee;2695;1561;18;1543;275;17.82242385
41738;Schwanenstadt;2967;1824;30;1794;399;22.24080268
41739;Seewalchen am Attersee;4514;2817;62;2755;484;17.56805808
41740;Steinbach am Attersee;679;422;8;414;42;10.14492754
41741;Straß im Attergau;1164;693;12;681;158;23.20117474
41742;Tiefgraben;2967;1641;23;1618;236;14.58590853
41743;Timelkam;4414;2776;52;2724;454;16.66666667
41744;Ungenach;1178;854;16;838;151;18.01909308
41745;Unterach am Attersee;1179;615;4;611;82;13.42062193
41746;Vöcklabruck;8994;5229;66;5163;859;16.63761379
41747;Vöcklamarkt;3812;2434;51;2383;478;20.05874948
41748;Weißenkirchen im Attergau;771;503;4;499;113;22.64529058
41749;Weyregg am Attersee;1275;758;11;747;106;14.19009371
41750;Wolfsegg am Hausruck;1518;929;16;913;142;15.55312158
41751;Zell am Moos;1229;718;5;713;140;19.63534362
41752;Zell am Pettenfirst;1010;680;10;670;104;15.52238806
41800;Wels-Land;54787;43501;616;42885;9025;21.04465431
41801;Aichkirchen;452;311;3;308;65;21.1038961
41802;Bachmanning;511;331;7;324;67;20.67901235
41803;Bad Wimsbach-Neydharting;2017;1326;22;1304;228;17.48466258
41804;Buchkirchen;3299;2114;33;2081;424;20.3748198
41805;Eberstalzell;2054;1371;21;1350;336;24.88888889
41806;Edt bei Lambach;1750;1129;20;1109;242;21.82146078
41807;Fischlham;1091;723;16;707;140;19.8019802
41808;Gunskirchen;4639;3022;43;2979;637;21.38301443
41809;Holzhausen;758;490;2;488;101;20.69672131
41810;Krenglbach;2470;1626;26;1600;318;19.875
41811;Lambach;2371;1306;11;1295;281;21.6988417
41812;Marchtrenk;9807;6249;119;6130;1445;23.5725938
41813;Neukirchen bei Lambach;729;464;9;455;97;21.31868132
41814;Offenhausen;1274;866;12;854;217;25.40983607
41815;Pennewang;722;486;5;481;100;20.79002079
41816;Pichl bei Wels;2209;1516;23;1493;330;22.10314802
41817;Sattledt;1972;1277;17;1260;318;25.23809524
41818;Schleißheim;1053;717;15;702;132;18.8034188
41819;Sipbachzell;1575;1091;13;1078;226;20.96474954
41820;Stadl-Paura;3593;2053;34;2019;548;27.14214958
41821;Steinerkirchen an der Traun;1855;1276;17;1259;243;19.30103257
41822;Steinhaus;1716;1073;10;1063;298;28.03386642
41823;Thalheim bei Wels;4218;2630;20;2610;477;18.27586207
41824;Weißkirchen an der Traun;2652;1789;22;1767;344;19.4680249
50000;Salzburg;395640;302123;3798;298325;40830;13.68641582
50100;Salzburg Stadt;99178;69480;663;68817;7745;11.25448654
50101;Salzburg;99178;51873;547;51326;6443;12.553092
50200;Hallein;43516;34254;517;33737;4298;12.73972197
50201;Abtenau;4467;3172;58;3114;318;10.21194605
50202;Adnet;2824;2022;41;1981;230;11.61029783
50203;Annaberg-Lungötz;1715;1249;13;1236;173;13.99676375
50204;Golling an der Salzach;3044;2057;31;2026;278;13.72161895
50205;Hallein;13971;8477;129;8348;1267;15.17728797
50206;Krispl;688;530;8;522;90;17.24137931
50207;Kuchl;5490;3681;55;3626;447;12.32763376
50208;Oberalm;3288;2174;29;2145;291;13.56643357
50209;Puch bei Hallein;3394;2136;30;2106;238;11.30104463
50210;Rußbach am Paß Gschütt;627;453;8;445;55;12.35955056
50211;Sankt Koloman;1341;1031;20;1011;143;14.14441147
50212;Scheffau am Tennengebirge;1101;800;18;782;111;14.1943734
50213;Bad Vigaun;1566;1124;22;1102;169;15.33575318
50300;Salzburg-Umgebung;114287;89792;1085;88707;12343;13.91434723
50301;Anif;3075;1891;22;1869;245;13.10861423
50302;Anthering;2853;1935;23;1912;195;10.19874477
50303;Bergheim;4002;2554;30;2524;309;12.24247227
50304;Berndorf bei Salzburg;1388;903;16;887;142;16.00901917
50305;Bürmoos;3669;2367;44;2323;373;16.05682307
50306;Dorfbeuern;1205;850;12;838;113;13.48448687
50307;Ebenau;1100;757;10;747;116;15.52878179
50308;Elixhausen;2351;1538;15;1523;157;10.30860144
50309;Elsbethen;4253;2751;25;2726;309;11.3352898
50310;Eugendorf;5319;3482;44;3438;518;15.06689936
50311;Faistenau;2385;1662;18;1644;403;24.513382
50312;Fuschl am See;1105;736;6;730;106;14.52054795
50313;Göming;613;476;3;473;64;13.53065539
50314;Grödig;5115;3216;47;3169;408;12.87472389
50315;Großgmain;1821;1104;14;1090;220;20.18348624
50316;Hallwang;3274;2057;23;2034;256;12.58603736
50317;Henndorf am Wallersee;3739;2388;25;2363;397;16.80067711
50318;Hintersee;358;250;2;248;33;13.30645161
50319;Hof bei Salzburg;2687;1691;16;1675;242;14.44776119
50320;Köstendorf;2085;1385;17;1368;197;14.4005848
50321;Koppl;2733;1784;35;1749;222;12.69296741
50322;Lamprechtshausen;2899;1982;37;1945;319;16.40102828
50323;Mattsee;2511;1627;20;1607;161;10.01866833
50324;Neumarkt am Wallersee;4526;2706;43;2663;477;17.91212918
50325;Nußdorf am Haunsberg;1870;1289;20;1269;157;12.37194641
50326;Oberndorf bei Salzburg;4068;2455;28;2427;312;12.85537701
50327;Obertrum am See;3683;2528;30;2498;316;12.6501201
50328;Plainfeld;978;690;6;684;95;13.88888889
50329;Sankt Georgen bei Salzburg;2363;1674;25;1649;254;15.40327471
50330;Sankt Gilgen;2881;1647;13;1634;242;14.81028152
50331;Schleedorf;841;593;6;587;127;21.63543441
50332;Seeham;1483;945;13;932;128;13.73390558
50335;Straßwalchen;5500;3772;72;3700;648;17.51351351
50336;Strobl;2832;1759;29;1730;252;14.56647399
50337;Thalgau;4633;2912;53;2859;486;16.99895068
50338;Wals-Siezenheim;10031;6461;79;6382;988;15.48104043
50339;Seekirchen am Wallersee;8058;5242;54;5188;785;15.1310717
50400;Sankt Johann im Pongau;58389;45705;681;45024;6953;15.44287491
50401;Altenmarkt im Pongau;3106;1971;32;1939;296;15.26560083
50402;Bad Hofgastein;4973;3099;45;3054;471;15.42239686
50403;Bad Gastein;2699;1704;40;1664;339;20.37259615
50404;Bischofshofen;7434;4552;81;4471;777;17.37866249
50405;Dorfgastein;1284;924;13;911;112;12.29418222
50406;Eben im Pongau;1723;1220;21;1199;209;17.43119266
50407;Filzmoos;1019;716;11;705;102;14.46808511
50408;Flachau;2088;1510;22;1488;268;18.01075269
50409;Forstau;437;326;1;325;54;16.61538462
50410;Goldegg;2006;1334;29;1305;222;17.01149425
50411;Großarl;2853;2036;35;2001;189;9.445277361
50412;Hüttau;1058;732;22;710;153;21.54929577
50413;Hüttschlag;703;522;7;515;49;9.514563107
50414;Kleinarl;600;430;4;426;51;11.97183099
50415;Mühlbach am Hochkönig;1129;728;8;720;97;13.47222222
50416;Pfarrwerfen;1830;1235;16;1219;173;14.19196062
50417;Radstadt;3321;2022;25;1997;442;22.1331998
50418;Sankt Johann im Pongau;7895;5003;69;4934;839;17.00445886
50419;Sankt Martin am Tennengebirge;1267;864;14;850;92;10.82352941
50420;Sankt Veit im Pongau;2944;2078;45;2033;264;12.98573537
50421;Schwarzach im Pongau;2523;1516;29;1487;209;14.05514459
50422;Untertauern;326;159;0;159;32;20.12578616
50423;Wagrain;2215;1388;27;1361;252;18.51579721
50424;Werfen;2240;1433;21;1412;265;18.76770538
50425;Werfenweng;716;473;5;468;130;27.77777778
50500;Tamsweg;16110;12548;164;12384;2496;20.15503876
50501;Göriach;300;191;4;187;33;17.64705882
50502;Lessach;451;312;3;309;54;17.47572816
50503;Mariapfarr;1929;1134;15;1119;178;15.90705987
50504;Mauterndorf;1236;818;12;806;135;16.74937965
50505;Muhr;414;286;4;282;62;21.9858156
50506;Ramingstein;895;540;8;532;125;23.4962406
50507;Sankt Andrä im Lungau;631;390;6;384;88;22.91666667
50508;Sankt Margarethen im Lungau;537;373;7;366;78;21.31147541
50509;Sankt Michael im Lungau;2737;1698;19;1679;351;20.90530077
50510;Tamsweg;4529;2510;42;2468;577;23.37925446
50511;Thomatal;276;190;6;184;58;31.52173913
50512;Tweng;172;82;1;81;14;17.28395062
50513;Unternberg;798;534;6;528;116;21.96969697
50514;Weißpriach;243;159;1;158;27;17.08860759
50515;Zederhaus;962;622;10;612;146;23.85620915
50600;Zell am See;64160;49131;674;48457;6887;14.21260086
50601;Bramberg am Wildkogel;3173;2062;29;2033;303;14.90408264
50602;Bruck an der Großglocknerstraße;3475;2175;43;2132;328;15.38461538
50603;Dienten am Hochkönig;612;358;6;352;34;9.659090909
50604;Fusch an der Großglocknerstraße;538;372;6;366;36;9.836065574
50605;Hollersbach im Pinzgau;961;670;12;658;100;15.19756839
50606;Kaprun;2102;1320;14;1306;117;8.958652374
50607;Krimml;641;408;5;403;51;12.65508685
50608;Lend;1007;688;14;674;101;14.9851632
50609;Leogang;2463;1751;20;1731;148;8.549971115
50610;Lofer;1512;957;19;938;136;14.4989339
50611;Maishofen;2645;1640;24;1616;216;13.36633663
50612;Maria Alm am Steinernen Meer;1571;1032;11;1021;128;12.5367287
50613;Mittersill;3907;2452;33;2419;488;20.17362547
50614;Neukirchen am Großvenediger;2045;1153;21;1132;162;14.31095406
50615;Niedernsill;2119;1411;31;1380;262;18.98550725
50616;Piesendorf;2860;1744;25;1719;278;16.17219314
50617;Rauris;2425;1576;21;1555;244;15.69131833
50618;Saalbach-Hinterglemm;1992;1248;14;1234;147;11.91247974
50619;Saalfelden am Steinernen Meer;12029;7455;97;7358;1046;14.21581952
50620;Sankt Martin bei Lofer;875;598;6;592;58;9.797297297
50621;Stuhlfelden;1282;952;21;931;228;24.48979592
50622;Taxenbach;2116;1465;14;1451;267;18.40110269
50623;Unken;1425;984;18;966;229;23.70600414
50624;Uttendorf;2330;1402;28;1374;242;17.61280932
50625;Viehhofen;448;272;3;269;69;25.65055762
50626;Wald im Pinzgau;865;520;6;514;94;18.28793774
50627;Weißbach bei Lofer;308;219;3;216;25;11.57407407
50628;Zell am See;6434;3624;53;3571;516;14.44973397
60000;Steiermark;965659;722189;7019;715170;131999;18.45701022
60100;Graz Stadt;196811;144095;957;143138;16921;11.82145901
60101;Graz;196811;109463;817;108646;14151;13.02486976
60300;Deutschlandsberg;50286;37108;390;36718;8067;21.97015088
60305;Frauental an der Laßnitz;2377;1308;14;1294;245;18.93353941
60318;Lannach;2842;1595;13;1582;334;21.1125158
60323;Pölfing-Brunn;1383;757;13;744;188;25.2688172
60324;Preding;1471;833;8;825;169;20.48484848
60326;Sankt Josef (Weststeiermark);1288;887;12;875;157;17.94285714
60329;Sankt Peter im Sulmtal;1084;628;8;620;164;26.4516129
60341;Wettmannstätten;1342;852;12;840;213;25.35714286
60344;Deutschlandsberg;9381;4955;48;4907;951;19.38047687
60345;Eibiswald;5426;3141;33;3108;811;26.09395109
60346;Groß Sankt Florian;3436;2035;19;2016;430;21.32936508
60347;Sankt Martin im Sulmtal;2610;1686;24;1662;426;25.63176895
60348;Sankt Stefan ob Stainz;2993;1943;15;1928;506;26.24481328
60349;Schwanberg;3836;2348;26;2322;551;23.7295435
60350;Stainz;7173;4166;59;4107;978;23.81300219
60351;Wies;3644;2108;20;2088;536;25.67049808
60600;Graz-Umgebung;121062;91641;791;90850;17392;19.14364337
60608;Feldkirchen bei Graz;4601;2633;21;2612;657;25.15313936
60611;Gössendorf;3041;1823;14;1809;477;26.3681592
60613;Gratkorn;6219;3538;25;3513;884;25.16367777
60617;Hart bei Graz;4027;2314;13;2301;386;16.77531508
60618;Haselsdorf-Tobelbad;1212;713;3;710;148;20.84507042
60619;Hausmannstätten;2678;1688;13;1675;257;15.34328358
60623;Kainbach bei Graz;2317;1195;15;1180;136;11.52542373
60624;Kalsdorf bei Graz;5254;2860;27;2833;601;21.2142605
60626;Kumberg;3088;1815;19;1796;271;15.08908686
60628;Laßnitzhöhe;2202;1252;11;1241;174;14.02095085
60629;Lieboch;4107;2333;24;2309;522;22.60718926
60632;Peggau;1726;1037;10;1027;238;23.17429406
60639;Sankt Bartholomä;1154;738;8;730;153;20.95890411
60641;Sankt Oswald bei Plankenwarth;1049;620;4;616;115;18.66883117
60642;Sankt Radegund bei Graz;1797;1024;11;1013;113;11.15498519
60645;Semriach;2578;1617;25;1592;382;23.99497487
60646;Stattegg;2365;1445;8;1437;202;14.05706333
60647;Stiwoll;598;374;5;369;70;18.9701897
60648;Thal;1795;1120;10;1110;143;12.88288288
60651;Übelbach;1679;980;11;969;204;21.05263158
60653;Vasoldsberg;3688;2189;14;2175;561;25.79310345
60654;Weinitzen;2147;1302;6;1296;225;17.36111111
60655;Werndorf;1764;1087;12;1075;255;23.72093023
60656;Wundschuh;1247;863;10;853;145;16.99882767
60659;Deutschfeistritz;3386;2097;29;2068;514;24.8549323
60660;Dobl-Zwaring;2717;1740;17;1723;424;24.60824144
60661;Eggersdorf bei Graz;5322;3391;39;3352;634;18.91408115
60662;Fernitz-Mellach;3891;2482;30;2452;556;22.67536705
60663;Frohnleiten;5451;3224;35;3189;514;16.1179053
60664;Gratwein-Straßengel;10306;6431;70;6361;1256;19.74532306
60665;Hitzendorf;5808;3629;21;3608;738;20.45454545
60666;Nestelbach bei Graz;2190;1266;13;1253;254;20.27134876
60667;Raaba-Grambach;3461;2221;24;2197;318;14.47428311
60668;Sankt Marein bei Graz;3035;1917;22;1895;382;20.15831135
60669;Seiersberg-Pirka;8444;5289;36;5253;1060;20.17894536
60670;Premstätten;4718;2625;29;2596;546;21.03235747
61000;Leibnitz;66098;48163;487;47676;10855;22.76826915
61001;Allerheiligen bei Wildon;1224;782;16;766;129;16.84073107
61002;Arnfels;802;473;6;467;100;21.41327623
61007;Empersdorf;1154;776;9;767;177;23.07692308
61008;Gabersdorf;959;624;10;614;155;25.24429967
61012;Gralla;1928;1127;14;1113;272;24.43845463
61013;Großklein;1883;1150;6;1144;291;25.43706294
61016;Heimschuh;1616;1035;13;1022;263;25.73385519
61017;Hengsberg;1183;697;12;685;167;24.37956204
61019;Kitzeck im Sausal;1036;646;11;635;127;20
61020;Lang;1070;712;9;703;116;16.50071124
61021;Lebring-Sankt Margarethen;1680;1020;9;1011;207;20.47477745
61024;Oberhaag;1702;1107;9;1098;271;24.68123862
61027;Ragnitz;1257;784;5;779;199;25.54557125
61030;Sankt Andrä-Höch;1470;933;17;916;268;29.25764192
61032;Sankt Johann im Saggautal;1693;1037;12;1025;281;27.41463415
61033;Sankt Nikolai im Sausal;1900;1146;16;1130;250;22.12389381
61043;Tillmitsch;2752;1629;8;1621;418;25.78655151
61045;Wagna;4721;2667;34;2633;620;23.54728447
61049;Ehrenhausen an der Weinstraße;1981;1122;17;1105;263;23.80090498
61050;Gamlitz;2646;1704;11;1693;430;25.39870053
61051;Gleinstätten;2350;1465;18;1447;346;23.91154112
61052;Heiligenkreuz am Waasen;2241;1439;18;1421;367;25.82688248
61053;Leibnitz;9471;5165;42;5123;1182;23.0724185
61054;Leutschach an der Weinstraße;3048;1763;24;1739;481;27.65957447
61055;Sankt Georgen an der Stiefing;1225;797;5;792;133;16.79292929
61056;Sankt Veit in der Südsteiermark;3317;2028;18;2010;435;21.64179104
61057;Schwarzautal;1900;1180;14;1166;266;22.81303602
61058;Straß in Steiermark;3671;2130;17;2113;563;26.64458116
61059;Wildon;4218;2360;18;2342;517;22.07514944
61100;Leoben;48192;35049;337;34712;6487;18.68806177
61101;Eisenerz;3468;1996;27;1969;312;15.84560691
61105;Kalwang;825;515;6;509;79;15.52062868
61106;Kammern im Liesingtal;1326;847;12;835;167;20
61107;Kraubath an der Mur;1131;668;7;661;143;21.63388805
61108;Leoben;18457;9707;115;9592;1931;20.13135947
61109;Mautern in Steiermark;1502;1035;6;1029;141;13.70262391
61110;Niklasdorf;1923;1178;9;1169;262;22.41231822
61111;Proleb;1318;803;9;794;131;16.49874055
61112;Radmer;485;317;1;316;43;13.60759494
61113;Sankt Michael in Obersteiermark;2444;1565;20;1545;332;21.48867314
61114;Sankt Peter-Freienstein;1929;1116;13;1103;268;24.29737081
61115;Sankt Stefan ob Leoben;1625;1007;11;996;191;19.17670683
61116;Traboch;1167;723;5;718;155;21.58774373
61118;Vordernberg;790;471;1;470;91;19.36170213
61119;Wald am Schoberpaß;462;291;4;287;43;14.9825784
61120;Trofaiach;9340;5662;53;5609;1130;20.14619362
61200;Liezen;62618;45819;523;45296;8073;17.82276581
61203;Aigen im Ennstal;2185;1372;22;1350;335;24.81481481
61204;Altaussee;1534;761;10;751;59;7.856191744
61205;Altenmarkt bei Sankt Gallen;661;446;11;435;44;10.11494253
61206;Ardning;1032;728;7;721;165;22.88488211
61207;Bad Aussee;3659;1939;20;1919;195;10.16154247
61213;Gröbming;2249;1221;16;1205;253;20.99585062
61215;Grundlsee;1010;567;14;553;41;7.414104882
61217;Haus;1913;1114;21;1093;212;19.39615737
61222;Lassing;1450;821;10;811;187;23.05795314
61236;Ramsau am Dachstein;2149;1302;12;1290;259;20.07751938
61243;Selzthal;1239;766;10;756;91;12.03703704
61247;Trieben;2644;1555;22;1533;370;24.13568167
61251;Wildalpen;411;286;5;281;29;10.3202847
61252;Wörschach;919;633;9;624;80;12.82051282
61253;Admont;4092;2331;24;2307;417;18.07542263
61254;Aich;1015;691;5;686;117;17.05539359
61255;Bad Mitterndorf;3850;2095;16;2079;458;22.02982203
61256;Gaishorn am See;1087;693;12;681;132;19.38325991
61257;Irdning-Donnersbachtal;3385;1935;24;1911;452;23.65253794
61258;Landl;2346;1525;29;1496;238;15.90909091
61259;Liezen;5918;3246;34;3212;574;17.87048568
61260;Michaelerberg-Pruggern;869;578;2;576;96;16.66666667
61261;Mitterberg-Sankt Martin;1537;923;9;914;169;18.49015317
61262;Öblarn;1557;892;12;880;173;19.65909091
61263;Rottenmann;4010;2374;32;2342;536;22.88642186
61264;Sankt Gallen;1428;878;15;863;130;15.06373117
61265;Schladming;5065;2647;25;2622;555;21.16704805
61266;Sölk;1254;753;8;745;158;21.20805369
61267;Stainach-Pürgg;2150;1167;17;1150;185;16.08695652
61400;Murau;23117;17868;216;17652;3231;18.30387492
61410;Mühlen;746;551;13;538;104;19.33085502
61413;Niederwölz;476;297;3;294;50;17.00680272
61425;St. Peter am Kammersberg;1701;1038;6;1032;143;13.85658915
61428;Schöder;783;501;3;498;85;17.06827309
61437;Krakau;1205;809;7;802;147;18.32917706
61438;Murau;2977;1642;17;1625;260;16
61439;Neumarkt in der Steiermark;4154;2332;29;2303;560;24.31610942
61440;Oberwölz;2475;1574;23;1551;263;16.95680206
61441;Ranten;987;665;7;658;91;13.82978723
61442;Sankt Georgen am Kreischberg;1406;782;4;778;167;21.46529563
61443;Sankt Lambrecht;1510;920;7;913;153;16.75794085
61444;Scheifling;1754;959;7;952;229;24.05462185
61445;Stadl-Predlitz;1394;880;13;867;173;19.9538639
61446;Teufenbach-Katsch;1549;929;20;909;183;20.1320132
61600;Voitsberg;42717;31038;316;30722;7167;23.32855934
61611;Krottendorf-Gaisfeld;2075;1323;7;1316;263;19.98480243
61612;Ligist;2719;1736;17;1719;432;25.13089005
61615;Mooskirchen;1797;1043;11;1032;241;23.35271318
61618;Rosental an der Kainach;1412;855;8;847;219;25.85596222
61621;Sankt Martin am Wöllmißberg;693;450;5;445;101;22.69662921
61624;Stallhofen;2586;1604;24;1580;460;29.11392405
61625;Voitsberg;7829;4540;44;4496;1128;25.08896797
61626;Bärnbach;4638;2822;35;2787;662;23.75313958
61627;Edelschrott;1477;849;7;842;181;21.49643705
61628;Geistthal-Södingberg;1295;782;9;773;195;25.22639069
61629;Hirschegg-Pack;889;572;7;565;124;21.94690265
61630;Kainach bei Voitsberg;1353;900;13;887;222;25.02818489
61631;Köflach;8247;5195;59;5136;1334;25.97352025
61632;Maria Lankowitz;2382;1433;25;1408;357;25.35511364
61633;Söding-Sankt Johann;3325;1864;12;1852;374;20.19438445
61700;Weiz;72629;55799;669;55130;10940;19.84400508
61701;Albersdorf-Prebuch;1663;1119;7;1112;243;21.85251799
61708;Fischbach;1273;935;16;919;237;25.78890098
61710;Floing;978;633;8;625;140;22.4
61711;Gasen;726;564;11;553;59;10.66907776
61716;Markt Hartmannsdorf;2381;1588;20;1568;344;21.93877551
61719;Hofstätten an der Raab;1797;1123;11;1112;229;20.59352518
61727;Ludersdorf-Wilfersdorf;1896;1152;15;1137;249;21.89973615
61728;Miesenbach bei Birkfeld;582;468;12;456;104;22.80701754
61729;Mitterdorf an der Raab;1720;1162;20;1142;209;18.30122592
61730;Mortantsch;1719;1209;14;1195;209;17.48953975
61731;Naas;1149;779;12;767;157;20.46936115
61740;Puch bei Weiz;1698;1088;20;1068;208;19.47565543
61741;Ratten;939;633;8;625;95;15.2
61743;Rettenegg;596;409;5;404;62;15.34653465
61744;St. Kathrein am Hauenstein;524;399;3;396;78;19.6969697
61745;Sankt Kathrein am Offenegg;908;635;11;624;110;17.62820513
61746;St. Margarethen an der Raab;3308;2147;26;2121;440;20.74493164
61748;Sinabelkirchen;3363;2207;31;2176;639;29.36580882
61750;Strallegg;1553;1209;10;1199;272;22.68557131
61751;Thannhausen;1965;1314;20;1294;218;16.84698609
61756;Anger;3383;2338;35;2303;420;18.23708207
61757;Birkfeld;4192;2763;35;2728;681;24.96334311
61758;Fladnitz an der Teichalm;1478;1095;15;1080;240;22.22222222
61759;Gersdorf an der Feistritz;1399;1032;11;1021;261;25.56317336
61760;Gleisdorf;8469;4672;45;4627;811;17.52755565
61761;Gutenberg-Stenzengreith;1455;941;11;930;178;19.13978495
61762;Ilztal;1784;1225;13;1212;271;22.35973597
61763;Passail;3495;2413;24;2389;462;19.33863541
61764;Pischelsdorf am Kulm;3004;1971;28;1943;525;27.02007205
61765;Sankt Ruprecht an der Raab;4234;2676;44;2632;641;24.35410334
61766;Weiz;8998;5268;68;5200;772;14.84615385
62000;Murtal;58084;42479;408;42071;7762;18.4497635
62007;Fohnsdorf;6457;3589;30;3559;791;22.2253442
62008;Gaal;1114;770;6;764;107;14.0052356
62010;Hohentauern;350;222;3;219;38;17.35159817
62014;Kobenz;1568;959;14;945;153;16.19047619
62021;Pusterwald;374;259;4;255;45;17.64705882
62026;Sankt Georgen ob Judenburg;706;441;5;436;56;12.8440367
62032;Sankt Peter ob Judenburg;898;619;6;613;88;14.35562806
62034;Seckau;1065;726;6;720;101;14.02777778
62036;Unzmarkt-Frauenburg;1115;680;6;674;143;21.21661721
62038;Zeltweg;5537;3086;31;3055;696;22.78232406
62039;Lobmingtal;1504;897;10;887;168;18.94024803
62040;Judenburg;8068;4267;46;4221;866;20.51646529
62041;Knittelfeld;9073;4820;55;4765;1025;21.51101784
62042;Obdach;3159;1924;22;1902;317;16.66666667
62043;Pöls-Oberkurzheim;2522;1414;14;1400;250;17.85714286
62044;Pölstal;2227;1410;10;1400;289;20.64285714
62045;Sankt Marein-Feistritz;1635;1043;6;1037;204;19.67213115
62046;Sankt Margarethen bei Knittelfeld;2250;1427;21;1406;244;17.3541963
62047;Spielberg;4430;2685;20;2665;524;19.66228893
62048;Weißkirchen in Steiermark;4032;2529;25;2504;398;15.89456869
62100;Bruck-Mürzzuschlag;79291;58705;676;58029;10525;18.13748298
62105;Breitenau am Hochlantsch;1398;864;19;845;134;15.85798817
62115;Krieglach;4464;2630;44;2586;511;19.76024749
62116;Langenwang;3301;1891;21;1870;375;20.05347594
62125;Pernegg an der Mur;1947;1292;22;1270;238;18.74015748
62128;Sankt Lorenzen im Mürztal;2931;1692;17;1675;312;18.62686567
62131;Spital am Semmering;1260;794;8;786;183;23.28244275
62132;Stanz im Mürztal;1530;987;10;977;164;16.78607984
62135;Turnau;1312;907;7;900;172;19.11111111
62138;Aflenz;2055;1254;7;1247;186;14.91579791
62139;Bruck an der Mur;12660;7256;96;7160;1314;18.35195531
62140;Kapfenberg;16522;8784;80;8704;1846;21.20863971
62141;Kindberg;6853;4013;59;3954;659;16.66666667
62142;Mariazell;3089;1822;27;1795;320;17.82729805
62143;Mürzzuschlag;6700;3612;42;3570;688;19.27170868
62144;Neuberg an der Mürz;2064;1238;11;1227;272;22.16788916
62145;Sankt Barbara im Mürztal;5582;3111;42;3069;657;21.40762463
62146;Sankt Marein im Mürztal;2095;1301;19;1282;292;22.77691108
62147;Thörl;1943;1194;19;1175;210;17.87234043
62148;Tragöß-Sankt Katharein;1585;994;13;981;199;20.28542304
62200;Hartberg-Fürstenfeld;74303;58024;663;57361;12583;21.93650738
62202;Bad Blumau;1302;923;15;908;254;27.97356828
62205;Buch-St. Magdalena;1812;1293;11;1282;333;25.975039
62206;Burgau;846;538;7;531;102;19.20903955
62209;Ebersdorf;1053;750;13;737;220;29.85074627
62211;Friedberg;2148;1416;20;1396;287;20.55873926
62214;Greinbach;1477;1080;12;1068;297;27.80898876
62216;Großsteinbach;1060;757;12;745;160;21.47651007
62219;Hartberg;5333;3151;37;3114;600;19.26782274
62220;Hartberg Umgebung;1757;1263;11;1252;260;20.76677316
62226;Lafnitz;1141;823;14;809;205;25.33992583
62232;Ottendorf an der Rittschein;1302;810;8;802;184;22.94264339
62233;Pinggau;2555;1696;27;1669;417;24.98502097
62235;Pöllauberg;1724;1246;9;1237;251;20.29102668
62242;Sankt Jakob im Walde;866;606;5;601;96;15.9733777
62244;Sankt Johann in der Haide;1796;1173;15;1158;315;27.20207254
62245;Sankt Lorenzen am Wechsel;1261;895;15;880;188;21.36363636
62247;Schäffern;1098;823;15;808;173;21.41089109
62252;Söchau;1212;783;5;778;178;22.87917738
62256;Stubenberg;1830;1124;16;1108;228;20.57761733
62262;Wenigzell;1146;828;6;822;138;16.78832117
62264;Bad Waltersdorf;3125;2178;43;2135;512;23.98126464
62265;Dechantskirchen;1699;1187;20;1167;214;18.33761782
62266;Feistritztal;1995;1259;20;1239;310;25.02017756
62267;Fürstenfeld;6929;4130;33;4097;828;20.20990969
62268;Grafendorf bei Hartberg;2595;1834;24;1810;434;23.97790055
62269;Großwilfersdorf;1678;1078;15;1063;201;18.90874882
62270;Hartl;1768;1280;15;1265;351;27.74703557
62271;Ilz;3039;2060;31;2029;524;25.82552982
62272;Kaindorf;2416;1560;13;1547;365;23.59405301
62273;Loipersdorf bei Fürstenfeld;1544;1009;15;994;262;26.35814889
62274;Neudau;1036;661;8;653;119;18.22358346
62275;Pöllau;5088;3393;30;3363;652;19.38745168
62276;Rohr bei Hartberg;1217;820;9;811;216;26.63378545
62277;Rohrbach an der Lafnitz;2256;1545;24;1521;399;26.23274162
62278;Vorau;3942;2761;28;2733;665;24.33223564
62279;Waldbach-Mönichwald;1257;934;5;929;194;20.88266954
62300;Südoststeiermark;70451;52868;562;52306;11631;22.23645471
62311;Edelsbach bei Feldbach;1110;795;9;786;173;22.01017812
62314;Eichkögl;1060;692;11;681;193;28.34067548
62326;Halbenrain;1480;895;16;879;218;24.80091013
62330;Jagerberg;1383;895;10;885;236;26.66666667
62332;Kapfenstein;1281;860;7;853;208;24.38452521
62335;Klöch;1022;673;11;662;83;12.53776435
62343;Mettersdorf am Saßbach;1074;653;6;647;144;22.25656878
62347;Murfeld;1367;843;7;836;189;22.6076555
62368;Tieschen;1042;647;10;637;132;20.72213501
62372;Unterlamm;1053;673;8;665;198;29.77443609
62375;Bad Gleichenberg;4240;2323;31;2292;508;22.16404887
62376;Bad Radkersburg;2500;1388;11;1377;257;18.6637618
62377;Deutsch Goritz;1526;1009;13;996;193;19.37751004
62378;Fehring;6032;3729;66;3663;884;24.13322413
62379;Feldbach;10300;6283;58;6225;1404;22.55421687
62380;Gnas;5057;3421;46;3375;846;25.06666667
62381;Kirchbach-Zerlach;2721;1804;14;1790;446;24.91620112
62382;Kirchberg an der Raab;3713;2279;20;2259;588;26.02921647
62383;Mureck;2856;1701;15;1686;368;21.82680902
62384;Paldau;2608;1674;24;1650;433;26.24242424
62385;Pirching am Traubenberg;2100;1335;4;1331;319;23.96694215
62386;Riegersburg;4135;2513;24;2489;486;19.52591402
62387;Sankt Anna am Aigen;2042;1324;18;1306;285;21.82235835
62388;Sankt Peter am Ottersbach;2458;1502;22;1480;383;25.87837838
62389;Sankt Stefan im Rosental;3277;2260;14;2246;522;23.2413179
62390;Straden;3014;1963;23;1940;392;20.20618557
70000;Tirol;543044;390148;2989;387159;56867;14.68828053
70100;Innsbruck Stadt;86625;61175;432;60743;8163;13.43858552
70101;Innsbruck;86625;46195;370;45825;6976;15.22313148
70200;Imst;44604;30931;256;30675;4922;16.04563977
70201;Arzl im Pitztal;2364;1459;19;1440;226;15.69444444
70202;Haiming;3541;2046;7;2039;357;17.50858264
70203;Imst;7483;4117;30;4087;690;16.88279912
70204;Imsterberg;627;395;7;388;77;19.84536082
70205;Jerzens;704;454;4;450;82;18.22222222
70206;Karres;507;335;5;330;88;26.66666667
70207;Karrösten;564;347;4;343;53;15.45189504
70208;Längenfeld;3444;2119;20;2099;258;12.29156741
70209;Mieming;2819;1699;20;1679;244;14.5324598
70210;Mils bei Imst;467;322;0;322;49;15.2173913
70211;Mötz;931;480;3;477;77;16.14255765
70212;Nassereith;1663;999;7;992;176;17.74193548
70213;Obsteig;964;557;7;550;84;15.27272727
70214;Oetz;1764;1053;11;1042;136;13.05182342
70215;Rietz;1816;1080;15;1065;245;23.00469484
70216;Roppen;1343;803;11;792;105;13.25757576
70217;St. Leonhard im Pitztal;1078;630;4;626;89;14.2172524
70218;Sautens;1128;617;1;616;100;16.23376623
70219;Silz;1966;1151;10;1141;184;16.12620508
70220;Sölden;2186;1199;8;1191;165;13.85390428
70221;Stams;1122;630;3;627;102;16.26794258
70222;Tarrenz;2100;1200;10;1190;289;24.28571429
70223;Umhausen;2414;1431;12;1419;266;18.74559549
70224;Wenns;1609;874;6;868;140;16.12903226
70300;Innsbruck-Land;132217;97644;703;96941;14517;14.97508794
70301;Absam;5720;3557;26;3531;494;13.990371
70302;Aldrans;1976;1196;6;1190;135;11.34453782
70303;Ampass;1308;796;5;791;121;15.29709229
70304;Axams;4670;2715;18;2697;415;15.38746756
70305;Baumkirchen;956;531;3;528;92;17.42424242
70306;Birgitz;1118;699;6;693;88;12.6984127
70307;Ellbögen;911;608;3;605;89;14.7107438
70308;Flaurling;982;635;7;628;73;11.62420382
70309;Fritzens;1669;1012;4;1008;169;16.76587302
70310;Fulpmes;3091;1792;14;1778;285;16.02924634
70311;Gnadenwald;620;401;3;398;49;12.31155779
70312;Götzens;3091;1794;13;1781;307;17.23750702
70313;Gries am Brenner;991;630;1;629;134;21.3036566
70314;Gries im Sellrain;478;327;3;324;32;9.87654321
70315;Grinzens;1078;646;5;641;112;17.47269891
70317;Gschnitz;342;211;6;205;37;18.04878049
70318;Hatting;1079;624;5;619;103;16.63974152
70319;Inzing;2958;1843;12;1831;246;13.43528127
70320;Kematen in Tirol;2211;1265;11;1254;196;15.62998405
70322;Kolsass;1260;828;9;819;129;15.75091575
70323;Kolsassberg;626;400;2;398;84;21.10552764
70325;Lans;821;475;4;471;62;13.16348195
70326;Leutasch;1601;866;7;859;122;14.20256112
70327;Matrei am Brenner;714;442;8;434;64;14.74654378
70328;Mieders;1336;766;8;758;117;15.4353562
70329;Mils;3412;2216;16;2200;326;14.81818182
70330;Mühlbachl;1055;618;9;609;88;14.4499179
70331;Mutters;1610;1020;6;1014;128;12.62327416
70332;Natters;1604;951;1;950;122;12.84210526
70333;Navis;1616;1030;6;1024;158;15.4296875
70334;Neustift im Stubaital;3477;2245;20;2225;403;18.11235955
70335;Oberhofen im Inntal;1367;868;5;863;184;21.32097335
70336;Obernberg am Brenner;289;217;1;216;53;24.53703704
70337;Oberperfuss;2419;1553;16;1537;179;11.64606376
70338;Patsch;811;515;2;513;69;13.4502924
70339;Pettnau;847;479;6;473;73;15.43340381
70340;Pfaffenhofen;825;413;2;411;70;17.03163017
70341;Pfons;1004;643;7;636;93;14.62264151
70342;Polling in Tirol;850;524;9;515;120;23.30097087
70343;Ranggen;835;563;5;558;78;13.97849462
70344;Reith bei Seefeld;873;480;2;478;61;12.76150628
70345;Rinn;1448;966;4;962;155;16.11226611
70346;Rum;6810;4116;32;4084;699;17.11557297
70347;St. Sigmund im Sellrain;139;95;1;94;13;13.82978723
70348;Scharnitz;867;450;5;445;75;16.85393258
70349;Schmirn;709;545;5;540;55;10.18518519
70350;Schönberg im Stubaital;714;425;5;420;50;11.9047619
70351;Seefeld in Tirol;2063;1101;2;1099;158;14.3767061
70352;Sellrain;1090;620;6;614;63;10.26058632
70353;Sistrans;1735;1114;5;1109;111;10.00901713
70354;Hall in Tirol;9567;5539;49;5490;885;16.12021858
70355;Steinach am Brenner;2693;1605;27;1578;258;16.34980989
70356;Telfes im Stubai;1212;728;8;720;101;14.02777778
70357;Telfs;10899;5533;52;5481;953;17.38733808
70358;Thaur;3031;1981;15;1966;316;16.07324517
70359;Trins;1036;667;7;660;82;12.42424242
70360;Tulfes;1208;772;4;768;141;18.359375
70361;Unterperfuss;182;67;0;67;10;14.92537313
70362;Vals;447;289;6;283;42;14.8409894
70364;Völs;5133;3078;24;3054;481;15.74983628
70365;Volders;3403;2075;21;2054;417;20.30185005
70366;Wattenberg;587;387;0;387;107;27.64857881
70367;Wattens;6030;3397;27;3370;664;19.70326409
70368;Wildermieming;709;467;4;463;58;12.52699784
70369;Zirl;6004;3471;21;3450;529;15.33333333
70400;Kitzbühel;45891;33504;241;33263;4350;13.07759372
70401;Aurach bei Kitzbühel;826;498;6;492;69;14.02439024
70402;Brixen im Thale;1995;1207;8;1199;116;9.674728941
70403;Fieberbrunn;3279;2043;16;2027;231;11.39615195
70404;Going am Wilden Kaiser;1290;743;7;736;134;18.20652174
70405;Hochfilzen;927;570;7;563;64;11.36767318
70406;Hopfgarten im Brixental;4236;2701;17;2684;376;14.00894188
70407;Itter;896;615;2;613;101;16.47634584
70408;Jochberg;1160;705;6;699;113;16.16595136
70409;Kirchberg in Tirol;3674;2162;12;2150;276;12.8372093
70410;Kirchdorf in Tirol;2840;1752;5;1747;294;16.82884946
70411;Kitzbühel;5776;2930;30;2900;433;14.93103448
70412;Kössen;2985;1722;13;1709;248;14.51141018
70413;Oberndorf in Tirol;1636;988;10;978;120;12.26993865
70414;Reith bei Kitzbühel;1141;672;2;670;78;11.64179104
70415;St. Jakob in Haus;575;377;5;372;27;7.258064516
70416;St. Johann in Tirol;6569;3754;39;3715;542;14.58950202
70417;St. Ulrich am Pillersee;1214;756;6;750;91;12.13333333
70418;Schwendt;581;354;2;352;58;16.47727273
70419;Waidring;1522;981;3;978;177;18.09815951
70420;Westendorf;2769;1690;16;1674;175;10.45400239
70500;Kufstein;76997;55189;386;54803;8948;16.32757331
70501;Alpbach;1912;1338;7;1331;194;14.57550714
70502;Angath;750;445;1;444;87;19.59459459
70503;Bad Häring;2003;1244;8;1236;154;12.45954693
70504;Brandenberg;1219;775;9;766;113;14.75195822
70505;Breitenbach am Inn;2668;1885;13;1872;319;17.04059829
70506;Brixlegg;2248;1312;7;1305;252;19.31034483
70508;Ebbs;4083;2571;21;2550;469;18.39215686
70509;Ellmau;1867;1163;6;1157;209;18.06395851
70510;Erl;1053;735;6;729;85;11.65980796
70511;Kirchbichl;4328;2778;26;2752;528;19.18604651
70512;Kramsach;3827;2412;27;2385;448;18.78406709
70513;Kufstein;12099;6531;44;6487;1076;16.58702019
70514;Kundl;3331;1992;15;1977;353;17.85533637
70515;Langkampfen;3045;1948;10;1938;397;20.48503612
70516;Mariastein;306;186;2;184;29;15.76086957
70517;Münster;2609;1631;10;1621;340;20.97470697
70518;Niederndorf;2033;1288;13;1275;248;19.45098039
70519;Niederndorferberg;490;304;3;301;45;14.95016611
70520;Radfeld;1772;1035;7;1028;251;24.41634241
70521;Rattenberg;256;155;0;155;38;24.51612903
70522;Reith im Alpbachtal;1998;1259;7;1252;179;14.2971246
70523;Rettenschöss;375;227;3;224;24;10.71428571
70524;Scheffau am Wilden Kaiser;1060;622;4;618;74;11.97411003
70525;Schwoich;1911;1291;5;1286;203;15.78538103
70526;Söll;2647;1698;6;1692;213;12.58865248
70527;Thiersee;2120;1502;8;1494;203;13.58768407
70528;Angerberg;1464;975;5;970;147;15.15463918
70529;Walchsee;1312;825;7;818;161;19.68215159
70530;Wildschönau;3179;2144;15;2129;307;14.41991545
70531;Wörgl;9032;4883;49;4834;895;18.51468763
70600;Landeck;33612;23809;191;23618;2517;10.65712592
70601;Faggen;291;162;3;159;19;11.94968553
70602;Fendels;209;136;1;135;5;3.703703704
70603;Fiss;721;415;2;413;22;5.326876513
70604;Fließ;2346;1500;8;1492;226;15.14745308
70605;Flirsch;774;477;9;468;48;10.25641026
70606;Galtür;606;415;2;413;49;11.86440678
70607;Grins;1098;638;3;635;78;12.28346457
70608;Ischgl;1234;786;2;784;82;10.45918367
70609;Kappl;2064;1408;5;1403;164;11.68923735
70610;Kaunerberg;324;204;1;203;15;7.389162562
70611;Kaunertal;465;301;0;301;8;2.657807309
70612;Kauns;401;225;1;224;14;6.25
70613;Ladis;418;233;1;232;34;14.65517241
70614;Landeck;5576;3131;39;3092;383;12.38680466
70615;Nauders;1097;678;6;672;81;12.05357143
70616;Pettneu am Arlberg;1122;673;5;668;67;10.02994012
70617;Pfunds;1976;1191;10;1181;145;12.27773074
70618;Pians;610;408;2;406;49;12.06896552
70619;Prutz;1330;744;8;736;86;11.68478261
70620;Ried im Oberinntal;907;508;0;508;56;11.02362205
70621;St. Anton am Arlberg;1763;931;9;922;56;6.073752711
70622;Schönwies;1308;858;10;848;93;10.96698113
70623;See;948;599;1;598;107;17.89297659
70624;Serfaus;865;525;2;523;39;7.456978967
70625;Spiss;90;50;0;50;9;18
70626;Stanz bei Landeck;476;315;8;307;15;4.885993485
70627;Strengen;977;624;14;610;73;11.96721311
70628;Tobadill;404;239;3;236;25;10.59322034
70629;Tösens;577;315;8;307;46;14.98371336
70630;Zams;2635;1597;11;1586;137;8.638083228
70700;Lienz;39536;28023;287;27736;4103;14.79304875
70701;Abfaltersbach;511;364;6;358;39;10.89385475
70702;Ainet;764;478;5;473;89;18.81606765
70703;Amlach;373;246;8;238;54;22.68907563
70704;Anras;989;672;7;665;75;11.27819549
70705;Assling;1489;1003;9;994;111;11.16700201
70706;Außervillgraten;640;461;3;458;36;7.860262009
70707;Dölsach;1858;1122;16;1106;182;16.4556962
70708;Gaimberg;678;443;8;435;61;14.02298851
70709;Hopfgarten in Defereggen;587;358;8;350;36;10.28571429
70710;Innervillgraten;741;470;5;465;34;7.311827957
70711;Iselsberg-Stronach;479;266;6;260;39;15
70712;Kals am Großglockner;940;537;7;530;89;16.79245283
70713;Kartitsch;635;397;2;395;30;7.594936709
70714;Lavant;261;176;1;175;44;25.14285714
70715;Leisach;596;358;5;353;50;14.16430595
70716;Lienz;9441;5216;57;5159;724;14.03372747
70717;Matrei in Osttirol;3840;2247;11;2236;536;23.97137746
70718;Nikolsdorf;701;421;3;418;47;11.24401914
70719;Nußdorf-Debant;2743;1531;18;1513;299;19.76206213
70720;Oberlienz;1232;715;6;709;97;13.68124118
70721;Obertilliach;571;401;6;395;34;8.607594937
70723;Prägraten am Großvenediger;959;551;6;545;119;21.83486239
70724;St. Jakob in Defereggen;700;432;6;426;55;12.91079812
70725;St. Johann im Walde;227;163;0;163;26;15.95092025
70726;St. Veit in Defereggen;532;349;4;345;50;14.49275362
70727;Schlaiten;388;236;4;232;35;15.0862069
70728;Sillian;1650;1066;10;1056;125;11.83712121
70729;Strassen;624;413;5;408;29;7.107843137
70731;Thurn;510;322;3;319;38;11.91222571
70732;Tristach;1165;740;10;730;84;11.50684932
70733;Untertilliach;183;95;0;95;7;7.368421053
70734;Virgen;1750;980;11;969;276;28.48297214
70735;Heinfels;779;499;4;495;52;10.50505051
70800;Reutte;22562;15753;138;15615;2019;12.92987512
70801;Bach;486;278;8;270;44;16.2962963
70802;Berwang;405;278;1;277;40;14.44043321
70803;Biberwier;443;285;3;282;48;17.0212766
70804;Bichlbach;549;326;3;323;35;10.83591331
70805;Breitenwang;1086;590;4;586;67;11.4334471
70806;Ehenbichl;622;381;5;376;47;12.5
70807;Ehrwald;1722;946;5;941;153;16.25929862
70808;Elbigenalp;644;364;4;360;50;13.88888889
70809;Elmen;286;176;4;172;14;8.139534884
70810;Forchach;193;132;1;131;34;25.95419847
70811;Grän;369;236;3;233;20;8.583690987
70812;Gramais;32;24;0;24;0;0
70813;Häselgehr;530;269;5;264;38;14.39393939
70814;Heiterwang;400;228;2;226;35;15.48672566
70815;Hinterhornbach;70;57;0;57;6;10.52631579
70816;Höfen;930;528;2;526;61;11.59695817
70817;Holzgau;299;199;2;197;30;15.2284264
70818;Jungholz;97;52;0;52;5;9.615384615
70819;Kaisers;58;41;0;41;4;9.756097561
70820;Lechaschau;1506;813;12;801;124;15.48064919
70821;Lermoos;745;441;2;439;54;12.30068337
70822;Musau;283;182;0;182;17;9.340659341
70823;Namlos;60;45;0;45;13;28.88888889
70824;Nesselwängle;320;173;1;172;23;13.37209302
70825;Pfafflar;85;44;0;44;5;11.36363636
70826;Pflach;911;513;5;508;72;14.17322835
70827;Pinswang;277;178;2;176;19;10.79545455
70828;Reutte;4179;2058;11;2047;255;12.45725452
70829;Schattwald;301;157;1;156;8;5.128205128
70830;Stanzach;350;213;4;209;31;14.83253589
70831;Steeg;523;353;3;350;41;11.71428571
70832;Tannheim;703;395;6;389;52;13.36760925
70833;Vils;1063;623;6;617;72;11.66936791
70834;Vorderhornbach;208;151;1;150;23;15.33333333
70835;Wängle;705;422;4;418;45;10.76555024
70836;Weißenbach am Lech;951;494;9;485;108;22.26804124
70837;Zöblen;171;99;1;98;11;11.2244898
70900;Schwaz;61000;42596;346;42250;7213;17.07218935
70901;Achenkirch;1573;854;5;849;142;16.72555948
70902;Aschau im Zillertal;1330;702;11;691;116;16.78726483
70903;Brandberg;277;166;0;166;37;22.28915663
70904;Bruck am Ziller;854;564;2;562;105;18.68327402
70905;Buch in Tirol;2018;1214;10;1204;281;23.33887043
70907;Eben am Achensee;2088;1095;5;1090;177;16.23853211
70908;Finkenberg;1080;656;4;652;77;11.80981595
70909;Fügen;2810;1465;13;1452;274;18.87052342
70910;Fügenberg;1047;592;1;591;109;18.44331641
70911;Gallzein;495;326;2;324;91;28.08641975
70912;Gerlos;596;395;0;395;62;15.69620253
70913;Gerlosberg;375;232;2;230;41;17.82608696
70914;Hainzenberg;530;323;4;319;56;17.55485893
70915;Hart im Zillertal;1187;675;5;670;120;17.91044776
70916;Hippach;1097;625;1;624;71;11.37820513
70917;Jenbach;4919;2638;24;2614;522;19.96939556
70918;Kaltenbach;913;540;4;536;89;16.60447761
70920;Mayrhofen;2599;1380;11;1369;193;14.09788167
70921;Pill;915;599;15;584;172;29.45205479
70922;Ramsau im Zillertal;1234;673;6;667;123;18.44077961
70923;Ried im Zillertal;910;561;8;553;62;11.21157324
70924;Rohrberg;432;265;0;265;41;15.47169811
70925;Schlitters;1080;636;11;625;103;16.48
70926;Schwaz;9973;5537;64;5473;970;17.72336927
70927;Schwendau;1254;706;7;699;105;15.02145923
70928;Stans;1632;1031;7;1024;173;16.89453125
70929;Steinberg am Rofan;210;125;1;124;12;9.677419355
70930;Strass im Zillertal;648;414;2;412;55;13.34951456
70931;Stumm;1466;828;18;810;119;14.69135802
70932;Stummerberg;671;370;0;370;67;18.10810811
70933;Terfens;1618;1039;5;1034;172;16.6344294
70934;Tux;1399;926;13;913;99;10.84337349
70935;Uderns;1338;746;2;744;162;21.77419355
70936;Vomp;3831;2323;20;2303;440;19.10551455
70937;Weer;1208;712;4;708;131;18.50282486
70938;Weerberg;1933;1248;11;1237;210;16.97655618
70939;Wiesing;1652;957;2;955;203;21.2565445
70940;Zell am Ziller;1289;695;3;692;132;19.07514451
70941;Zellberg;519;296;2;294;58;19.72789116
80000;Vorarlberg;274500;185860;1427;184433;27121;14.70506905
80100;Bludenz;45458;31518;271;31247;4981;15.94073031
80101;Bartholomäberg;1767;1026;11;1015;250;24.63054187
80102;Blons;237;163;0;163;19;11.65644172
80103;Bludenz;9598;4860;54;4806;745;15.50145651
80104;Bludesch;1558;839;8;831;161;19.37424789
80105;Brand;487;278;1;277;45;16.24548736
80106;Bürs;2313;1193;15;1178;194;16.46859083
80107;Bürserberg;425;225;3;222;39;17.56756757
80108;Dalaas;1143;662;7;655;117;17.86259542
80109;Fontanella;338;231;1;230;15;6.52173913
80110;Gaschurn;1127;595;4;591;131;22.16582064
80111;Innerbraz;744;442;1;441;64;14.51247166
80112;Klösterle;500;271;3;268;38;14.17910448
80113;Lech;1144;455;3;452;19;4.203539823
80114;Lorüns;198;135;2;133;26;19.54887218
80115;Ludesch;2452;1277;8;1269;207;16.31205674
80116;Nenzing;4570;2562;27;2535;585;23.07692308
80117;Nüziders;3722;2131;17;2114;273;12.91390728
80118;Raggal;637;410;3;407;38;9.336609337
80119;St. Anton im Montafon;524;311;6;305;50;16.39344262
80120;St. Gallenkirch;1689;879;8;871;209;23.99540758
80121;St. Gerold;295;186;1;185;30;16.21621622
80122;Schruns;2753;1443;15;1428;226;15.82633053
80123;Silbertal;679;414;5;409;91;22.24938875
80124;Sonntag;496;331;7;324;19;5.864197531
80125;Stallehr;203;116;1;115;19;16.52173913
80126;Thüringen;1618;939;8;931;128;13.74865736
80127;Thüringerberg;550;371;5;366;42;11.47540984
80128;Tschagguns;1688;893;1;892;157;17.60089686
80129;Vandans;2003;1101;12;1089;239;21.94674013
80200;Bregenz;92351;63309;476;62833;8683;13.81917145
80201;Alberschwende;2431;1559;14;1545;238;15.40453074
80202;Andelsbuch;1880;1147;18;1129;93;8.237378211
80203;Au;1353;805;7;798;98;12.28070175
80204;Bezau;1412;774;7;767;84;10.9517601
80205;Bildstein;594;363;6;357;53;14.84593838
80206;Bizau;786;484;5;479;44;9.185803758
80207;Bregenz;19132;9770;77;9693;1444;14.8973486
80208;Buch;464;328;3;325;63;19.38461538
80209;Damüls;225;153;1;152;11;7.236842105
80210;Doren;748;533;5;528;69;13.06818182
80211;Egg;2720;1643;17;1626;191;11.74661747
80212;Eichenberg;263;173;4;169;7;4.142011834
80213;Fußach;2692;1486;8;1478;295;19.9594046
80214;Gaißau;1325;726;8;718;122;16.99164345
80215;Hard;9324;4860;35;4825;759;15.73056995
80216;Hittisau;1407;845;7;838;129;15.39379475
80217;Höchst;5701;2737;19;2718;431;15.85724798
80218;Hörbranz;4579;2559;24;2535;422;16.6469428
80219;Hohenweiler;916;509;2;507;69;13.60946746
80220;Kennelbach;1380;752;7;745;102;13.69127517
80221;Krumbach;794;486;7;479;99;20.66805846
80222;Langen bei Bregenz;1074;674;6;668;120;17.96407186
80223;Langenegg;823;529;4;525;76;14.47619048
80224;Lauterach;7106;4074;26;4048;712;17.58893281
80225;Lingenau;1089;703;3;700;64;9.142857143
80226;Lochau;4158;2069;8;2061;265;12.857836
80227;Mellau;939;544;4;540;97;17.96296296
80228;Mittelberg;2389;1171;5;1166;146;12.52144082
80229;Möggers;388;281;2;279;33;11.82795699
80230;Reuthe;445;228;3;225;36;16
80231;Riefensberg;700;457;4;453;76;16.77704194
80232;Schnepfau;334;195;1;194;17;8.762886598
80233;Schoppernau;703;486;3;483;69;14.28571429
80234;Schröcken;150;82;0;82;4;4.87804878
80235;Schwarzach;2848;1673;11;1662;243;14.62093863
80236;Schwarzenberg;1357;832;11;821;78;9.500609013
80237;Sibratsgfäll;318;223;7;216;21;9.722222222
80238;Sulzberg;1247;853;7;846;67;7.919621749
80239;Warth;140;73;0;73;7;9.589041096
80240;Wolfurt;6017;3553;35;3518;499;14.18419557
80300;Dornbirn;60679;38858;280;38578;6036;15.64622324
80301;Dornbirn;34009;18058;126;17932;2708;15.10149453
80302;Hohenems;11072;5245;40;5205;1077;20.69164265
80303;Lustenau;15598;7635;70;7565;1393;18.41374752
80400;Feldkirch;76012;51422;395;51027;7378;14.4590119
80401;Altach;5005;2669;21;2648;396;14.95468278
80402;Düns;312;212;1;211;31;14.69194313
80403;Dünserberg;106;60;1;59;11;18.6440678
80404;Feldkirch;23118;11841;76;11765;1912;16.25159371
80405;Frastanz;4371;2180;15;2165;382;17.6443418
80406;Fraxern;529;331;6;325;44;13.53846154
80407;Göfis;2517;1498;10;1488;224;15.05376344
80408;Götzis;8036;4242;42;4200;621;14.78571429
80409;Klaus;2264;1328;9;1319;125;9.476876422
80410;Koblach;3523;1889;16;1873;281;15.00266951
80411;Laterns;521;309;3;306;40;13.07189542
80412;Mäder;2908;1596;16;1580;311;19.6835443
80413;Meiningen;1595;869;6;863;161;18.65585168
80414;Rankweil;8406;4467;52;4415;630;14.26953567
80415;Röns;254;164;1;163;26;15.95092025
80416;Röthis;1562;834;5;829;94;11.33896261
80417;Satteins;2092;1259;21;1238;206;16.63974152
80418;Schlins;1673;995;3;992;165;16.63306452
80419;Schnifis;596;316;1;315;39;12.38095238
80420;Sulz;1887;1136;9;1127;141;12.51109139
80421;Übersaxen;490;308;3;305;60;19.67213115
80422;Viktorsberg;300;190;1;189;17;8.994708995
80423;Weiler;1508;770;3;767;107;13.95045632
80424;Zwischenwasser;2439;1385;11;1374;232;16.88500728
90000;Wien;1149664;827567;6653;820914;105289;12.82582585
90101;Innere Stadt;11772;5074;14;5060;455;8.992094862
90201;Leopoldstadt;59836;30199;249;29950;3213;10.7278798
90301;Landstraße;55943;27330;183;27147;2816;10.37315357
90401;Wieden;20440;9814;56;9758;758;7.767985243
90501;Margareten;31030;15205;91;15114;1370;9.064443562
90601;Mariahilf;20431;10075;54;10021;788;7.863486678
90701;Neubau;20645;10532;45;10487;670;6.388862401
90801;Josefstadt;15824;8058;48;8010;527;6.579275905
90901;Alsergrund;26128;13004;77;12927;984;7.611974936
91001;Favoriten;109553;55457;648;54809;9974;18.19774125
91101;Simmering;60628;30676;413;30263;6693;22.11611539
91201;Meidling;55143;27089;248;26841;3839;14.3027458
91301;Hietzing;38030;20564;131;20433;2050;10.03279009
91401;Penzing;59858;31338;282;31056;4041;13.01197836
91501;Rudolfsheim-Fünfhaus;39246;18717;148;18569;2172;11.69691421
91601;Ottakring;57151;28809;283;28526;3570;12.51489869
91701;Hernals;32524;16464;131;16333;1746;10.69001408
91801;Währing;32809;17036;102;16934;1368;8.078422109
91901;Döbling;48508;25563;174;25389;2758;10.86297215
92001;Brigittenau;46247;22535;203;22332;3265;14.62027584
92101;Floridsdorf;106895;56568;675;55893;11254;20.13490061
92201;Donaustadt;127344;69291;720;68571;12523;18.26282248
92301;Liesing;73679;41240;327;40913;6516;15.92647814
